District code,State name,District name,Population,Male,Female,Literate,Male_Literate,Female_Literate,Hindus,Muslims,Christians,Sikhs,Buddhists,Jains,Others_Religions,Religion_Not_Stated,Rural_Households,Urban_Households,Households
1,JAMMU AND KASHMIR,Kupwara,870354,474190,396164,439654,282823,156831,37128,823286,1700,5600,66,39,13,2522,158438,23226,181664
2,JAMMU AND KASHMIR,Badgam,753745,398041,355704,335649,207741,127908,10110,736054,1489,5559,47,6,2,478,160649,27190,187839
3,JAMMU AND KASHMIR,Leh(Ladakh),133487,78971,54516,93770,62834,30936,22882,19057,658,1092,88635,103,54,1006,36920,17474,54394
4,JAMMU AND KASHMIR,Kargil,140802,77785,63017,86236,56301,29935,10341,108239,604,1171,20126,28,4,289,40370,7774,48144
5,JAMMU AND KASHMIR,Punch,476835,251899,224936,261724,163333,98391,32604,431279,958,11188,83,10,2,711,132139,15269,147408
6,JAMMU AND KASHMIR,Rajouri,642415,345351,297064,364109,224469,139640,221880,402879,983,15513,189,26,3,942,196070,17508,213578
7,JAMMU AND KASHMIR,Kathua,616435,326109,290326,389204,228499,160705,540063,64234,1828,9551,24,16,2,717,181374,33473,214847
8,JAMMU AND KASHMIR,Baramula,1008039,534733,473306,545149,337170,207979,30621,959185,1497,14770,140,29,7,1790,210543,48932,259475
9,JAMMU AND KASHMIR,Bandipore,392232,207680,184552,185979,117058,68921,8439,382006,572,555,44,17,2,597,80521,17555,98076
10,JAMMU AND KASHMIR,Srinagar,1236829,651124,585705,748584,431746,316838,42540,1177342,2746,12187,285,74,2,1653,4518,257721,262239
11,JAMMU AND KASHMIR,Ganderbal,297446,158720,138726,143276,90581,52695,5592,290581,406,486,25,8,4,344,63788,13558,77346
12,JAMMU AND KASHMIR,Pulwama,560440,293064,267376,293958,178326,115632,13840,535159,1109,9440,35,6,18,833,147520,21703,169223
13,JAMMU AND KASHMIR,Shupiyan,266215,136480,129735,136500,80355,56145,3116,262263,429,178,6,1,6,216,75616,5272,80888
14,JAMMU AND KASHMIR,Anantnag,1078692,559767,518925,545532,324417,221115,13180,1057005,1449,6140,55,7,7,849,207067,70666,277733
15,JAMMU AND KASHMIR,Kulgam,424483,217620,206863,209085,125052,84033,4267,418076,460,1035,27,25,9,584,95952,25178,121130
16,JAMMU AND KASHMIR,Doda,409936,213641,196295,219083,138620,80463,187621,220614,472,422,21,22,42,722,122267,11350,133617
17,JAMMU AND KASHMIR,Ramban,283713,149132,134581,124065,82938,41127,81026,200516,414,753,43,3,252,706,84281,5341,89622
18,JAMMU AND KASHMIR,Kishtwar,230696,120165,110531,107506,68700,38806,93931,133225,277,450,2094,3,514,202,72378,5993,78371
19,JAMMU AND KASHMIR,Udhampur,554985,296784,258201,322354,197543,124811,489044,59771,1962,3418,106,57,235,392,148664,34696,183360
20,JAMMU AND KASHMIR,Reasi,314667,166461,148206,150542,93937,56605,153898,156275,1208,3107,15,7,3,154,95572,12261,107833
21,JAMMU AND KASHMIR,Jammu,1529958,813821,716137,1137135,641916,495219,1289240,107489,12104,114272,470,1987,321,4075,254566,248043,502609
22,JAMMU AND KASHMIR,Samba,318898,169124,149774,228139,130312,97827,275311,22950,2306,17961,48,16,6,300,94247,19989,114236
23,HIMACHAL PRADESH,Chamba,519080,261320,257760,323842,186064,137778,479782,32455,1559,2745,1740,57,14,728,186395,13836,200231
24,HIMACHAL PRADESH,Kangra,1510075,750591,759484,1152640,606443,546197,1461140,19797,3023,8929,14511,194,208,2273,588321,39007,627328
25,HIMACHAL PRADESH,Lahul AND Spiti,31564,16588,14976,21845,12897,8948,11649,74,212,35,19572,3,1,18,17434,0,17434
26,HIMACHAL PRADESH,Kullu,437903,225452,212451,307672,174550,133122,415669,2974,1568,1396,15377,94,83,742,167995,20709,188704
27,HIMACHAL PRADESH,Mandi,999777,498065,501712,723747,393669,330078,981412,9460,876,4081,2628,43,86,1191,431129,31696,462825
28,HIMACHAL PRADESH,Hamirpur,454768,217070,237698,358091,180555,177536,449412,3711,243,591,95,293,9,414,196116,15232,211348
29,HIMACHAL PRADESH,Una,521173,263692,257481,399715,213281,186434,480138,14275,390,26009,56,70,10,225,185091,20126,205217
30,HIMACHAL PRADESH,Bilaspur,381956,192764,189192,287620,155599,132021,371973,6984,236,2387,113,10,7,246,152458,11987,164445
31,HIMACHAL PRADESH,Solan,580320,308754,271566,428578,244372,184206,548579,14678,1452,13926,574,591,110,410,192787,51509,244296
32,HIMACHAL PRADESH,Sirmaur,529855,276289,253566,362645,205617,157028,476830,33215,577,15501,2645,236,86,765,171102,21054,192156
33,HIMACHAL PRADESH,Shimla,814010,425039,388971,612642,342846,269796,791449,11810,2025,4047,3262,185,197,1035,279269,95896,375165
34,HIMACHAL PRADESH,Kinnaur,84121,46249,37872,60699,36697,24002,64732,448,485,249,18086,29,45,47,44514,0,44514
35,PUNJAB,Gurdaspur,2298323,1212617,1085706,1634719,907660,727059,1074332,27667,176587,1002874,405,580,812,15066,420860,185488,606348
36,PUNJAB,Kapurthala,815168,426311,388857,576567,316254,260313,336124,10190,5445,453692,6662,553,334,2168,165433,95770,261203
37,PUNJAB,Jalandhar,2193590,1145211,1048379,1622537,882581,739956,1394329,30233,26016,718363,11385,4011,805,8448,330339,377791,708130
38,PUNJAB,Hoshiarpur,1586625,809057,777568,1199699,637927,561772,1000743,23089,14968,538208,3476,2034,531,3576,422673,128592,551265
39,PUNJAB,Shahid Bhagat Singh Nagar,612310,313291,299019,438459,239155,199304,401368,6829,1479,192885,5885,695,266,2903,183168,48383,231551
40,PUNJAB,Fatehgarh Sahib,600163,320795,279368,426033,238696,187337,152851,16808,1698,427521,48,178,251,808,117559,57337,174896
41,PUNJAB,Ludhiana,3498739,1867816,1630923,2560225,1428348,1131877,1502403,77713,16517,1863408,2007,19620,1254,15817,395032,641789,1036821
42,PUNJAB,Moga,995746,525920,469826,627889,348549,279340,158414,9388,3277,818921,178,436,365,4767,214295,74144,288439
43,PUNJAB,Firozpur,2029074,1071637,957437,1227511,707070,520441,906408,6844,19358,1090815,454,1143,278,3774,348522,153868,502390
44,PUNJAB,Muktsar,901896,475622,426274,524848,300401,224447,254920,4333,1681,638625,240,744,433,920,149507,74650,224157
45,PUNJAB,Faridkot,617508,326671,290837,381285,215767,165518,141363,3125,1227,469789,155,1109,103,637,99946,58917,158863
46,PUNJAB,Bathinda,1388525,743197,645328,844868,488261,356607,380569,16299,2474,984286,246,1266,559,2826,218159,137563,355722
47,PUNJAB,Mansa,769751,408732,361019,423560,244037,179523,156539,10375,917,598443,123,1577,493,1284,145603,50786,196389
48,PUNJAB,Patiala,1895686,1002522,893164,1266791,711052,555739,783306,40043,5683,1059944,245,1914,1410,3141,299279,218090,517369
49,PUNJAB,Amritsar,2490656,1318408,1172248,1684770,932981,751789,690939,12502,54344,1716935,876,3152,1044,10864,275477,385476,660953
50,PUNJAB,Tarn Taran,1119627,589369,530258,666162,376427,289735,60504,3855,6095,1044903,101,650,47,3472,222717,44457,267174
51,PUNJAB,Rupnagar,684627,357485,327142,502731,278534,224197,304481,14492,2094,361045,118,653,143,1601,148162,60537,208699
52,PUNJAB,Sahibzada Ajit Singh Nagar,994628,529253,465375,736575,409944,326631,476276,29488,5342,478908,257,1257,239,2861,117293,174042,291335
53,PUNJAB,Sangrur,1655169,878029,777140,1002077,570413,431664,389410,179116,2406,1077438,268,3222,1038,2271,292156,156788,448944
54,PUNJAB,Barnala,595527,317522,278005,359831,201999,157832,112859,13100,622,467751,108,246,481,360,102577,54222,156799
55,CHANDIGARH,Chandigarh,1055450,580663,474787,805438,465346,340092,852574,51447,8720,138329,1160,1960,246,1014,8911,289456,298367
56,UTTARAKHAND,Uttarkashi,330086,168597,161489,215126,128237,86889,324859,3554,353,167,563,74,105,411,112148,9061,121209
57,UTTARAKHAND,Chamoli,391605,193991,197614,280556,155395,125161,385818,4395,428,323,190,11,23,417,163434,22906,186340
58,UTTARAKHAND,Rudraprayag,242285,114589,127696,170933,91803,79130,240170,1486,171,38,9,4,44,363,112705,4454,117159
59,UTTARAKHAND,Tehri Garhwal,618931,297986,320945,407994,227406,180588,609835,7374,656,290,32,91,109,544,227059,27177,254236
60,UTTARAKHAND,Dehradun,1696694,892199,804495,1259506,702216,557290,1424916,202057,13416,36454,11778,5117,217,2739,228245,269393,497638
61,UTTARAKHAND,Garhwal,687271,326829,360442,494889,262148,232741,660507,22931,2161,619,58,212,51,732,279682,36780,316462
62,UTTARAKHAND,Pithoragarh,483439,239306,244133,345550,189623,155927,475105,6015,1401,260,185,13,30,430,183687,26256,209943
63,UTTARAKHAND,Bageshwar,259898,124326,135572,179483,97546,81937,257509,1440,397,46,102,7,16,381,96031,3880,99911
64,UTTARAKHAND,Almora,622506,291081,331425,436497,231604,204893,611250,7752,1895,256,201,31,6,1115,260056,21082,281138
65,UTTARAKHAND,Champawat,259648,131125,128523,177726,102015,75711,249563,8693,870,336,24,28,6,128,85202,12839,98041
66,UTTARAKHAND,Nainital,954605,493666,460939,696500,385779,310721,809717,120742,5091,17419,570,356,181,529,193086,105577,298663
67,UTTARAKHAND,Udham Singh Nagar,1648902,858783,790119,1037839,598525,439314,1104452,372267,6064,162768,505,738,159,1949,269406,145253,414659
68,UTTARAKHAND,Hardwar,1890422,1005295,885127,1178354,691411,486943,1214935,648119,4878,17364,709,2501,46,1870,301828,186183,488011
69,HARYANA,Panchkula,561293,299679,261614,405318,229862,175456,490702,23451,2583,40951,1008,1626,90,882,70895,93656,164551
70,HARYANA,Ambala,1128350,598703,529647,818025,461288,356737,955096,22143,3705,138202,381,4845,110,3868,175365,139891,315256
71,HARYANA,Yamunanagar,1214205,646718,567487,832457,474793,357664,984929,138569,3646,84455,161,1555,126,764,214464,143259,357723
72,HARYANA,Kurukshetra,964655,510976,453679,646893,370828,276065,805175,15970,1943,140395,214,375,106,477,203553,88268,291821
73,HARYANA,Kaithal,1074304,571003,503301,646529,385782,260747,974520,8232,1769,87558,265,351,70,1539,231091,75696,306787
74,HARYANA,Karnal,1505324,797712,707612,978013,564516,413497,1341002,31650,2049,126207,532,1516,49,2319,292682,135920,428602
75,HARYANA,Panipat,1205437,646857,558580,786599,464136,322463,1083936,86622,2261,25064,289,4647,99,2519,173502,153804,327306
76,HARYANA,Sonipat,1450001,781299,668702,998316,589881,408435,1390149,45100,1405,4484,336,6033,29,2465,283858,133576,417434
77,HARYANA,Jind,1334152,713006,621146,832758,502049,330709,1276669,23016,889,29103,172,2594,56,1653,278335,89665,368000
78,HARYANA,Fatehabad,942011,495360,446651,557578,327471,230107,779243,8360,996,150969,171,1172,530,570,203020,55360,258380
79,HARYANA,Sirsa,1295189,682582,612607,782897,456968,325929,940255,9524,2186,338962,370,2256,624,1012,245476,93316,338792
80,HARYANA,Hisar,1743931,931562,812369,1114311,670200,444111,1701061,21650,1945,12270,334,3620,33,3018,302013,154113,456126
81,HARYANA,Bhiwani,1634445,866672,767773,1069871,643158,426713,1611031,15515,873,2401,254,1016,26,3329,357047,99235,456282
82,HARYANA,Rohtak,1061204,568479,492725,747582,436025,311557,1043887,8185,732,3916,200,3491,24,769,175203,131739,306942
83,HARYANA,Jhajjar,958405,514667,443738,676091,399480,276611,945693,8247,734,1042,105,645,22,1917,211816,78328,290144
84,HARYANA,Mahendragarh,922088,486665,435423,630255,380440,249815,913251,5660,301,1737,75,644,15,405,223726,44216,267942
85,HARYANA,Rewari,900332,474335,425997,636947,375453,261494,889133,5713,701,1804,202,1525,12,1242,199449,69305,268754
86,HARYANA,Gurgaon,1514432,816690,697742,1111116,638666,472450,1408801,70842,9725,15097,944,7451,254,1318,141703,381988,523691
87,HARYANA,Mewat,1089263,571162,518101,454897,308435,146462,221846,862647,1235,592,516,1453,4,970,187398,36237,223635
88,HARYANA,Faridabad,1809733,966110,843623,1272739,734940,537799,1588407,161680,9743,34572,640,4883,249,9559,87700,382981,470681
89,HARYANA,Palwal,1042708,554497,488211,599796,379696,220100,826342,208566,932,3971,345,915,20,1617,186069,63090,249159
90,NCT OF DELHI,North West,3656539,1960922,1695617,2707855,1541952,1165903,3211042,291330,14100,92129,2281,43460,345,1852,67592,959275,1026867
91,NCT OF DELHI,North,887978,475002,412976,681517,381615,299902,726443,119792,7256,19066,1824,13049,81,467,4512,296559,301071
92,NCT OF DELHI,North East,2241624,1188425,1053199,1611588,912481,699107,1529337,657585,9123,17424,2388,24673,48,1046,5326,482255,487581
93,NCT OF DELHI,East,1709346,907500,801846,1352998,748382,604616,1410852,178807,15792,53027,2643,46927,366,932,1086,461132,462218
94,NCT OF DELHI,New Delhi,142004,77942,64062,114179,65678,48501,124482,8480,4852,2933,312,679,66,200,0,52664,52664
95,NCT OF DELHI,Central,582320,307821,274499,442360,240518,201842,364148,194278,3527,13038,362,5886,107,974,0,194897,194897
96,NCT OF DELHI,West,2543243,1356240,1187003,1961179,1093933,867246,2087294,149807,18337,271752,1993,11322,273,2465,1809,699703,701512
97,NCT OF DELHI,South West,2292958,1246046,1046912,1787689,1025261,762428,2102743,112691,31226,31692,2784,9215,266,2341,41179,606503,647682
98,NCT OF DELHI,South,2731929,1467428,1264501,2078402,1185036,893366,2155759,445914,41880,69520,3862,11020,645,3329,2918,728145,731063
99,RAJASTHAN,Ganganagar,1969168,1043340,925828,1193343,710908,482435,1437144,50688,2077,474853,938,1988,164,1316,397697,164897,562594
100,RAJASTHAN,Hanumangarh,1774692,931184,843508,1034136,624281,409855,1433067,118673,1542,216997,241,1935,138,2099,389059,108694,497753
101,RAJASTHAN,Bikaner,2363937,1240801,1123136,1278801,782399,496402,2073356,235741,1901,20072,285,30850,79,1653,335754,196179,531933
102,RAJASTHAN,Churu,2039547,1051446,988101,1149269,696729,452540,1777879,249736,958,402,188,7104,127,3153,344897,148996,493893
103,RAJASTHAN,Jhunjhunun,2137045,1095896,1041149,1370360,815834,554526,1905682,228178,1004,275,56,548,85,1217,500452,150357,650809
104,RAJASTHAN,Alwar,3674179,1939026,1735153,2182476,1359829,822647,3039279,547335,2696,64532,4384,13221,348,2384,782294,212967,995261
105,RAJASTHAN,Bharatpur,2548462,1355726,1192736,1480869,943910,536959,2143046,371286,1576,23456,899,5758,18,2423,479437,129697,609134
106,RAJASTHAN,Dhaulpur,1206516,653647,552869,683098,435721,247377,1127520,72258,688,1356,92,2739,21,1842,214670,58626,273296
107,RAJASTHAN,Karauli,1458248,783639,674609,805849,531904,273945,1370977,81553,602,297,70,3424,413,912,305047,59308,364355
108,RAJASTHAN,Sawai Madhopur,1335551,704031,631520,741748,486184,255564,1165505,155681,945,812,177,9991,42,2398,282057,71264,353321
109,RAJASTHAN,Dausa,1634409,857787,776622,938051,596935,341116,1582335,45488,439,296,94,3737,115,1905,361084,59610,420694
110,RAJASTHAN,Jaipur,6626178,3468507,3157671,4300965,2554793,1746172,5819980,687452,12708,18782,1020,81079,257,4900,754841,977838,1732679
111,RAJASTHAN,Sikar,2677333,1374990,1302343,1652117,995275,656842,2342076,327583,1122,356,177,4050,15,1954,527560,178274,705834
112,RAJASTHAN,Nagaur,3307743,1696325,1611418,1758624,1102750,655874,2833443,454487,1912,366,163,12940,276,4156,675712,166489,842201
113,RAJASTHAN,Jodhpur,3687165,1923928,1763237,2031532,1265753,765779,3224399,411558,6035,4123,514,36697,80,3759,584215,307442,891657
114,RAJASTHAN,Jaisalmer,669919,361708,308211,308653,210415,98238,497045,168129,874,1723,98,1521,34,495,159117,30830,189947
115,RAJASTHAN,Barmer,2603751,1369022,1234729,1188322,783461,404861,2244882,321192,1157,450,157,34010,34,1869,542825,55980,598805
116,RAJASTHAN,Jalor,1828730,936634,892096,829582,543923,285659,1732852,78990,730,231,144,14640,82,1061,419216,48202,467418
117,RAJASTHAN,Sirohi,1036346,534231,502115,476806,309900,166906,996562,30479,1284,572,114,6829,56,450,238535,69639,308174
118,RAJASTHAN,Pali,2037573,1025422,1012151,1085693,667381,418312,1870543,143476,1345,1540,141,18974,52,1502,512909,139808,652717
119,RAJASTHAN,Ajmer,2583052,1324085,1258967,1526673,926268,600405,2201663,314159,10605,6799,417,45614,184,3611,409335,274919,684254
120,RAJASTHAN,Tonk,1421326,728136,693190,749659,478329,271330,1243527,153146,754,378,122,22458,30,911,298911,81755,380666
121,RAJASTHAN,Bundi,1110906,577160,533746,585044,371705,213339,1017688,66609,682,11059,144,13455,24,1245,239836,63452,303288
122,RAJASTHAN,Bhilwara,2408523,1220736,1187787,1256126,777582,478544,2224839,142427,1978,1468,183,35149,60,2419,530015,145865,675880
123,RAJASTHAN,Rajsamand,1156597,581339,575258,619139,383334,235805,1105676,33677,759,260,100,14966,68,1091,304622,61054,365676
124,RAJASTHAN,Dungarpur,1388552,696532,692020,681591,415820,265771,1340065,28662,830,240,226,16141,853,1535,322816,31547,354363
125,RAJASTHAN,Banswara,1797485,907754,889731,829343,513854,315489,1701234,48834,22250,427,138,22613,109,1880,390437,39407,429844
126,RAJASTHAN,Chittaurgarh,1544338,783171,761167,821825,514851,306974,1413163,97855,1274,1515,252,25843,136,4300,366780,88873,455653
127,RAJASTHAN,Kota,1951014,1021161,929853,1298345,765396,532949,1661307,243993,5665,11058,280,25742,286,2683,203454,311735,515189
128,RAJASTHAN,Baran,1222755,633945,588810,693307,432607,260700,1133349,79984,1432,3066,84,2795,48,1997,249184,69804,318988
129,RAJASTHAN,Jhalawar,1411129,725143,685986,739792,466815,272977,1299751,96164,842,819,46,12488,42,977,298624,63763,362387
130,RAJASTHAN,Udaipur,3068420,1566801,1501619,1582629,973444,609185,2869976,104307,7406,4278,209,78647,373,3224,665449,182769,848218
131,RAJASTHAN,Pratapgarh,867848,437744,430104,401515,250122,151393,827293,25597,358,72,32,14077,27,392,209813,24269,234082
132,UTTAR PRADESH,Saharanpur,3466382,1834106,1632276,2077108,1220114,856994,1966892,1454052,6523,18627,1937,10208,135,8008,605082,284156,889238
133,UTTAR PRADESH,Muzaffarnagar,4143512,2193434,1950078,2417339,1448528,968811,2382914,1711453,6495,18601,1516,16345,60,6128,673746,296104,969850
134,UTTAR PRADESH,Bijnor,3682713,1921215,1761498,2135393,1241471,893922,2032081,1585210,6184,50624,1736,2134,41,4703,683875,224648,908523
135,UTTAR PRADESH,Moradabad,4772006,2503186,2268820,2263848,1357435,906413,2488265,2248392,13157,7555,1260,2426,382,10569,692398,355518,1047916
136,UTTAR PRADESH,Rampur,2335819,1223889,1111930,1043666,630408,413258,1073890,1181337,9201,65316,384,1307,63,4321,396775,143217,539992
137,UTTAR PRADESH,Jyotiba Phule Nagar,1840221,963449,876772,983110,600541,382569,1075440,750368,5952,5295,189,517,21,2439,335888,115486,451374
138,UTTAR PRADESH,Meerut,3443689,1825743,1617946,2141488,1254520,886968,2183255,1185643,10582,24912,1855,18544,236,18662,381520,422303,803823
139,UTTAR PRADESH,Baghpat,1303048,700070,602978,797970,489858,308112,917474,364583,1840,483,161,16139,25,2343,246055,69991,316046
140,UTTAR PRADESH,Ghaziabad,4681645,2488834,2192811,3123264,1811397,1311867,3414427,1186776,19026,23001,3487,16412,265,18251,355407,836316,1191723
141,UTTAR PRADESH,Gautam Buddha Nagar,1648115,890214,757901,1122947,666065,456882,1394025,215500,7366,9261,895,4518,91,16459,170835,338935,509770
142,UTTAR PRADESH,Bulandshahr,3499171,1845260,1653911,2031656,1253314,778342,2707195,777407,4088,2765,669,1572,86,5389,658449,221628,880077
143,UTTAR PRADESH,Aligarh,3673889,1951996,1721893,2092567,1283380,809187,2904140,729283,7635,5875,2582,2805,91,21478,582117,275942,858059
144,UTTAR PRADESH,Mahamaya Nagar,1564708,836127,728581,942572,579157,363415,1397225,159448,1350,524,424,1289,63,4385,288150,84883,373033
145,UTTAR PRADESH,Mathura,2547184,1367125,1180059,1507746,943346,564400,2310776,216933,3179,2872,883,2056,126,10359,407488,177802,585290
146,UTTAR PRADESH,Agra,4418797,2364953,2053844,2680510,1614594,1065916,3922718,411313,10076,12057,4049,21508,384,36692,496971,406852,903823
147,UTTAR PRADESH,Firozabad,2498156,1332046,1166110,1521806,912314,609492,2140745,314812,3370,1804,3395,19077,61,14892,349747,185621,535368
148,UTTAR PRADESH,Mainpuri,1868529,993377,875152,1203885,712110,491775,1746649,100723,1729,475,8814,4161,38,5940,338475,72783,411258
149,UTTAR PRADESH,Budaun,3681896,1967759,1714137,1547477,986501,560976,2867707,790515,6320,1135,1959,678,87,13495,710956,156668,867624
150,UTTAR PRADESH,Bareilly,4448359,2357665,2090694,2191759,1342697,849062,2830768,1536534,14822,28187,4371,931,339,32407,631613,362798,994411
151,UTTAR PRADESH,Pilibhit,2031007,1072002,959005,1061095,654290,406805,1449007,489686,3510,84787,360,138,45,3474,371752,89638,461390
152,UTTAR PRADESH,Shahjahanpur,3006538,1606403,1400135,1490930,915142,575788,2412595,527581,4630,51090,2312,301,84,7945,520289,134714,655003
153,UTTAR PRADESH,Kheri,4021243,2123187,1898056,2034044,1237157,796887,3078262,807600,7502,94388,18454,487,226,14324,754938,107672,862610
154,UTTAR PRADESH,Sitapur,4483992,2375264,2108728,2283733,1397702,886031,3555450,893725,6579,11611,2663,1410,79,12475,827583,111319,938902
155,UTTAR PRADESH,Hardoi,4092845,2191442,1901403,2221601,1374587,847014,3508131,556219,5822,5688,6671,446,98,9770,786613,121064,907677
156,UTTAR PRADESH,Unnao,3108367,1630087,1478280,1773584,1053063,720521,2732016,363453,3574,1204,920,240,31,6929,596317,121039,717356
157,UTTAR PRADESH,Lucknow,4589838,2394476,2195362,3127260,1742440,1384820,3537787,985070,20493,23883,3877,4975,504,13249,344155,717566,1061721
158,UTTAR PRADESH,Rae Bareli,3405559,1752542,1653017,1965843,1165965,799878,2975998,413243,3634,2424,722,397,602,8539,705025,73393,778418
159,UTTAR PRADESH,Farrukhabad,1885204,1006240,878964,1092677,654827,437850,1596278,276846,3137,3160,3161,487,100,2035,316647,94843,411490
160,UTTAR PRADESH,Kannauj,1656616,881776,774840,1017087,603596,413491,1375788,273967,1263,504,2033,606,65,2390,299785,65985,365770
161,UTTAR PRADESH,Etawah,1581810,845856,735954,1062003,623583,438420,1457892,113961,1362,1045,1733,3917,94,1806,265643,85483,351126
162,UTTAR PRADESH,Auraiya,1379545,740040,639505,930836,546198,384638,1273546,101963,1004,371,332,228,444,1657,255836,58438,314274
163,UTTAR PRADESH,Kanpur Dehat,1796184,963255,832929,1170243,692964,477279,1612968,176327,1300,478,819,155,103,4034,363933,41323,405256
164,UTTAR PRADESH,Kanpur Nagar,4581268,2459806,2121462,3243022,1829179,1413843,3792174,720660,15751,29676,2733,5710,589,13975,364869,684906,1049775
165,UTTAR PRADESH,Jalaun,1689974,906092,783882,1075196,653430,421766,1509708,171581,1148,463,2875,256,145,3798,304856,91565,396421
166,UTTAR PRADESH,Jhansi,1998603,1057436,941167,1304513,783705,520808,1823930,147842,7050,4951,1203,7328,311,5988,309592,195321,504913
167,UTTAR PRADESH,Lalitpur,1221592,641011,580581,641191,397586,243605,1163804,33724,1351,1034,69,20390,41,1179,258013,43819,301832
168,UTTAR PRADESH,Hamirpur,1104285,593537,510748,653299,408125,245174,1010014,91269,814,196,74,41,273,1604,256081,55300,311381
169,UTTAR PRADESH,Mahoba,875958,466358,409600,488106,302283,185823,815142,57454,965,389,94,234,157,1523,198298,48525,246823
170,UTTAR PRADESH,Banda,1799410,965876,833534,1002937,630626,372311,1637549,157612,1367,231,168,916,50,1517,378056,67569,445625
171,UTTAR PRADESH,Chitrakoot,991730,527721,464009,531072,330339,200733,955372,34559,693,63,101,285,27,630,207237,23558,230795
172,UTTAR PRADESH,Fatehpur,2632733,1384722,1248011,1512166,911003,601163,2274674,350700,2201,402,172,199,47,4338,558807,77733,636540
173,UTTAR PRADESH,Pratapgarh,3209141,1606085,1603056,1931559,1121381,810178,2731351,452394,3920,1451,7795,746,43,11441,711085,41701,752786
174,UTTAR PRADESH,Kaushambi,1599596,838485,761111,813424,507279,306145,1372381,220423,2225,522,687,545,3,2810,349856,30764,380620
175,UTTAR PRADESH,Allahabad,5954391,3131807,2822584,3665727,2199340,1466387,5102041,796756,13782,4377,4391,2247,305,30492,983266,265304,1248570
176,UTTAR PRADESH,Bara Banki,3260699,1707073,1553626,1692458,1010518,681940,2505444,737106,4857,2090,1553,3016,211,6422,635840,79068,714908
177,UTTAR PRADESH,Faizabad,2470996,1259628,1211368,1450901,838339,612562,2094271,365806,3225,1912,737,358,185,4502,510378,79288,589666
178,UTTAR PRADESH,Ambedkar Nagar,2397888,1212410,1185478,1486939,846676,640263,1985654,401678,2536,869,1817,235,33,5066,501559,65031,566590
179,UTTAR PRADESH,Sultanpur,3797117,1914586,1882531,2239902,1300248,939654,3119590,650261,4453,1629,9989,426,336,10433,839737,49891,889628
180,UTTAR PRADESH,Bahraich,3487731,1843884,1643847,1398368,878285,520083,2291892,1169330,6400,8212,2793,1177,38,7889,698520,61742,760262
181,UTTAR PRADESH,Shrawasti,1117361,593897,523464,423313,276700,146613,768643,343981,1427,407,323,68,56,2456,248770,8504,257274
182,UTTAR PRADESH,Balrampur,2148665,1114721,1033944,868357,544943,323414,1333242,805975,3228,900,1866,198,87,3169,410070,35768,445838
183,UTTAR PRADESH,Gonda,3433919,1787146,1646773,1679994,1034181,645813,2739076,678615,4735,1893,649,338,57,8556,673578,52794,726372
184,UTTAR PRADESH,Siddharthnagar,2559297,1295095,1264202,1228926,740718,488208,1789704,748073,3042,681,11964,179,356,5298,480165,33348,513513
185,UTTAR PRADESH,Basti,2464464,1255272,1209192,1393783,819719,574064,2082976,364510,3493,900,9753,107,99,2626,513960,31065,545025
186,UTTAR PRADESH,Sant Kabir Nagar,1715183,869656,845527,954949,567098,387851,1300586,404410,1766,447,4393,95,35,3451,324972,27179,352151
187,UTTAR PRADESH,Mahrajganj,2684703,1381754,1302949,1419144,881674,537470,2196884,458650,3527,1381,16030,243,338,7650,573046,34033,607079
188,UTTAR PRADESH,Gorakhpur,4440895,2277777,2163118,2700328,1593890,1106438,4009037,403847,9662,2123,2848,460,207,12711,761958,189170,951128
189,UTTAR PRADESH,Kushinagar,3564544,1818055,1746489,1954820,1183722,771098,2928462,620244,5006,767,4619,383,133,4930,742324,42775,785099
190,UTTAR PRADESH,Deoria,3100946,1537436,1563510,1875239,1079288,795951,2730957,358539,3626,818,1182,209,146,5469,597778,67928,665706
191,UTTAR PRADESH,Azamgarh,4613913,2285004,2328909,2771917,1559414,1212503,3878626,718692,3810,719,5652,183,226,6005,891024,80434,971458
192,UTTAR PRADESH,Mau,2205968,1114709,1091259,1363044,773082,589962,1769937,428555,2109,340,564,155,129,4179,352207,99321,451528
193,UTTAR PRADESH,Ballia,3239774,1672902,1566872,1963590,1160960,802630,3004240,213440,4463,892,1595,233,64,14847,564927,64454,629381
194,UTTAR PRADESH,Jaunpur,4494204,2220465,2273739,2731677,1565394,1166283,3981502,483750,4947,1286,7898,349,114,14358,926088,80582,1006670
195,UTTAR PRADESH,Ghazipur,3620268,1855075,1765193,2197549,1293553,903996,3233790,368153,4181,810,3145,213,184,9792,700173,61467,761640
196,UTTAR PRADESH,Chandauli,1952756,1017905,934851,1174606,699454,475152,1727869,215081,2153,1389,340,100,1175,4649,344937,50822,395759
197,UTTAR PRADESH,Varanasi,3676841,1921857,1754984,2403903,1389116,1014787,3107681,546987,7696,3309,1146,1898,298,7826,438935,316129,755064
198,UTTAR PRADESH,Sant Ravidas Nagar (Bhadohi),1578213,807099,771114,910146,546782,363364,1368291,203887,1365,199,1562,161,7,2741,293510,45997,339507
199,UTTAR PRADESH,Mirzapur,2496970,1312302,1184668,1428683,865837,562846,2292534,195765,2373,1133,341,701,27,4096,465152,77963,543115
200,UTTAR PRADESH,Sonbhadra,1862559,971344,891215,985708,601988,383720,1738769,103567,3963,1649,1747,487,1907,10470,337048,91040,428088
201,UTTAR PRADESH,Etah,1774480,947339,827141,1055202,647042,408160,1611126,146346,2464,708,2887,5671,18,5260,334246,67752,401998
202,UTTAR PRADESH,Kanshiram Nagar,1436719,764165,672554,724850,452803,272047,1211427,213822,1969,2280,3907,313,72,2929,271234,72490,343724
203,BIHAR,Pashchim Champaran,3935042,2061110,1873932,1759481,1091226,668255,3047427,865090,8469,926,1337,296,1895,9602,839514,96620,936134
204,BIHAR,Purba Champaran,5099371,2681209,2418162,2276957,1407603,869354,4086453,990349,4865,668,878,464,104,15590,1142260,101565,1243825
205,BIHAR,Sheohar,656246,346673,309573,283698,171645,112053,552492,99342,522,216,73,52,44,3505,158484,7516,166000
206,BIHAR,Sitamarhi,3423574,1803252,1620322,1436794,885188,551606,2672311,740101,2897,261,253,188,20,7543,807294,49670,856964
207,BIHAR,Madhubani,4487379,2329313,2158066,2155338,1340085,815253,3652168,818912,3262,564,328,442,169,11534,1047552,41234,1088786
208,BIHAR,Supaul,2229076,1155283,1073793,1033283,647672,385611,1809936,409251,3758,271,136,546,42,5136,572287,27815,600102
209,BIHAR,Araria,2811569,1463333,1348236,1195768,727643,468125,1593525,1207442,4116,371,187,1910,63,3955,659061,44213,703274
210,BIHAR,Kishanganj,1690400,866970,823430,745056,439921,305135,531236,1149095,5783,398,183,1476,28,2201,401793,43357,445150
211,BIHAR,Purnia,3264619,1699370,1565249,1332326,805261,527065,1989420,1255641,7989,614,353,1450,650,8502,712847,85749,798596
212,BIHAR,Katihar,3071029,1600430,1470599,1280190,762256,517934,1684589,1365645,8659,2754,212,507,2141,6522,668232,69838,738070
213,BIHAR,Madhepura,2001762,1047559,954203,834577,517666,316911,1753829,241760,1342,170,60,133,81,4387,486278,24000,510278
214,BIHAR,Saharsa,1900661,997174,903487,804996,506374,298622,1629254,266620,1292,197,60,109,8,3121,432651,38046,470697
215,BIHAR,Darbhanga,3937385,2059949,1877436,1816634,1125566,691068,3042729,881476,3534,832,245,236,101,8232,907174,95539,1002713
216,BIHAR,Muzaffarpur,4801062,2527497,2273565,2509232,1487117,1022115,4032773,745546,5149,933,288,382,98,15893,998694,120700,1119394
217,BIHAR,Gopalganj,2562012,1267666,1294346,1382998,793905,589093,2119262,436057,2463,271,167,133,28,3631,515925,38133,554058
218,BIHAR,Siwan,3330464,1675090,1655374,1930175,1115906,814269,2712635,608282,2618,369,407,359,86,5708,632514,41858,674372
219,BIHAR,Saran,3951862,2022821,1929041,2157454,1285767,871687,3534772,406449,2330,371,229,322,107,7282,701323,76299,777622
220,BIHAR,Vaishali,3495021,1844535,1650486,1926740,1152576,774164,3152346,333980,2203,707,362,246,71,5106,699317,51494,750811
221,BIHAR,Samastipur,4261566,2230003,2031563,2142880,1293575,849305,3800598,452370,2126,554,292,231,112,5283,1012979,43486,1056465
222,BIHAR,Begusarai,2970541,1567660,1402881,1548673,918507,630166,2554330,407348,2209,402,229,276,57,5690,594377,139248,733625
223,BIHAR,Khagaria,1666886,883786,783100,768028,461153,306875,1486989,175588,1253,143,79,86,115,2633,373696,21007,394703
224,BIHAR,Bhagalpur,3037766,1615663,1422103,1573066,937669,635397,2487866,537098,3556,415,180,1050,32,7569,522527,130634,653161
225,BIHAR,Banka,2034763,1067140,967623,965321,590961,374360,1772655,250925,6138,139,113,94,1035,3664,425604,18492,444096
226,BIHAR,Munger,1367765,729041,638724,801817,473741,328076,1252319,110416,1815,338,95,145,61,2576,222281,85782,308063
227,BIHAR,Lakhisarai,1000912,526345,474567,507270,305182,202088,956396,40886,487,140,52,78,52,2821,175882,31763,207645
228,BIHAR,Sheikhpura,636342,329743,306599,328676,196431,132245,596102,37653,313,75,41,43,31,2084,108293,24345,132638
229,BIHAR,Nalanda,2877653,1497060,1380593,1519933,919558,600375,2669775,198033,1978,393,414,561,64,6435,514141,102522,616663
230,BIHAR,Patna,5838465,3078512,2759953,3459679,2028047,1431632,5356075,439952,12551,4803,1062,2151,203,21668,657991,552103,1210094
231,BIHAR,Bhojpur,2728407,1430380,1298027,1599151,973486,625665,2518216,197819,2165,544,647,1472,48,7496,434559,77368,511927
232,BIHAR,Buxar,1706352,887977,818375,989807,593544,396263,1591454,105423,2125,248,5090,97,57,1858,299252,35405,334657
233,BIHAR,Kaimur (Bhabua),1626384,847006,779378,920276,549923,370353,1456229,155283,1407,296,7707,129,1534,3799,325143,15299,340442
234,BIHAR,Rohtas,2959918,1543546,1416372,1799832,1061783,738049,2645415,300487,2889,2569,1584,252,537,6185,512383,95678,608061
235,BIHAR,Aurangabad,2540073,1318684,1221389,1466002,868733,597269,2291133,237353,2218,295,334,775,19,7946,428291,49006,477297
236,BIHAR,Gaya,4391418,2266566,2124852,2297613,1368803,928810,3876395,488121,3943,913,870,1723,108,19345,696289,111282,807571
237,BIHAR,Nawada,2219146,1144668,1074478,1091012,659474,431538,1964620,244394,1299,250,176,279,80,8048,379551,45323,424874
238,BIHAR,Jamui,1760405,916064,844341,858588,534385,324203,1525746,217621,8443,162,159,87,3438,4749,325909,30851,356760
239,BIHAR,Jehanabad,1125313,585582,539731,618881,374412,244469,1045117,75742,691,148,248,60,58,3249,186660,28132,214792
240,BIHAR,Arwal,700843,363497,337346,386351,235279,151072,634099,64259,390,59,323,74,60,1579,134334,9960,144294
241,SIKKIM,North  District,43709,24730,18979,30450,18579,11871,14883,815,2660,816,23318,35,921,261,11543,2066,13609
242,SIKKIM,West District,136435,70238,66197,93432,51988,41444,75286,965,13002,40,36390,20,10477,255,32091,1886,33977
243,SIKKIM,South District,146850,76670,70180,106741,59357,47384,84583,1889,21462,151,35053,45,3176,491,31135,8163,39298
244,SIKKIM,East District,283583,151432,132151,214329,121345,92984,177910,6198,23398,861,72455,214,1726,821,40626,41512,82138
245,ARUNACHAL PRADESH,Tawang,49977,29151,20826,26073,17720,8353,11842,787,776,1164,34920,72,349,67,10730,2452,13182
246,ARUNACHAL PRADESH,West Kameng,83947,46155,37792,48492,29566,18926,31265,1970,8466,328,36087,71,5556,204,17889,6306,24195
247,ARUNACHAL PRADESH,East Kameng,78690,38775,39915,38449,21599,16850,12333,652,37136,36,452,23,27868,190,14503,5215,19718
248,ARUNACHAL PRADESH,Papum Pare,176573,89182,87391,121048,65794,55254,57027,6148,84397,310,4768,139,22586,1198,20308,30180,50488
249,ARUNACHAL PRADESH,Upper Subansiri,83448,41758,41690,45278,24807,20471,13474,521,8779,28,297,11,59449,889,14542,4672,19214
250,ARUNACHAL PRADESH,West Siang,112274,58168,54106,64746,36777,27969,15881,2218,29969,577,3311,49,60005,264,22272,8503,30775
251,ARUNACHAL PRADESH,East Siang,99214,50116,49098,62576,34210,28366,27854,2289,18254,69,776,30,49393,549,19497,9524,29021
252,ARUNACHAL PRADESH,Upper Siang,35320,18699,16621,18195,10723,7472,5261,411,5643,27,2577,7,20967,427,8569,2182,10751
253,ARUNACHAL PRADESH,Changlang,148226,76948,71278,73174,44027,29147,47683,2134,35969,94,50381,95,11738,132,33422,6498,39920
254,ARUNACHAL PRADESH,Tirap,111975,57604,54371,47974,29313,18661,20682,1103,83361,61,778,43,5325,622,18420,6500,24920
255,ARUNACHAL PRADESH,Lower Subansiri,83030,41843,41187,54057,29470,24587,9551,1482,34402,27,193,13,37085,277,18112,5365,23477
256,ARUNACHAL PRADESH,Kurung Kumey,92076,45318,46758,36606,20258,16348,4859,471,51189,43,121,81,34158,1154,18603,1092,19695
257,ARUNACHAL PRADESH,Dibang Valley,8004,4414,3590,4436,2614,1822,3141,111,223,7,126,2,4267,127,2055,1175,3230
258,ARUNACHAL PRADESH,Lower Dibang Valley,54080,28053,26027,31849,18087,13762,28915,2247,9213,33,2932,19,10393,328,12000,3950,15950
259,ARUNACHAL PRADESH,Lohit,145726,76221,69505,83062,48380,34682,99020,3846,10684,210,24452,104,7277,133,33599,11372,44971
260,ARUNACHAL PRADESH,Anjaw,21167,11507,9660,9990,6523,3467,13088,655,271,273,644,12,6137,87,6025,428,6453
261,NAGALAND,Mon,250260,131753,118507,119626,67432,52194,8102,3444,236494,84,1256,314,1,565,43607,7415,51022
262,NAGALAND,Mokokchung,194622,101092,93530,159494,83479,76015,9840,2057,181847,78,442,66,6,286,37536,17742,55278
263,NAGALAND,Zunheboto,140757,71217,69540,102881,53504,49377,2580,772,136995,39,286,6,2,77,31267,6044,37311
264,NAGALAND,Wokha,166343,84505,81838,128208,67385,60823,5605,2043,158236,34,318,8,20,79,38499,8170,46669
265,NAGALAND,Dimapur,378811,197394,181417,278037,150142,127895,108900,31212,234239,566,1270,2148,157,319,49116,62853,111969
266,NAGALAND,Phek,163418,83743,79675,105893,57926,47967,3563,950,158224,31,350,17,198,85,38903,7295,46198
267,NAGALAND,Tuensang,196596,101933,94663,117511,63653,53858,2979,1052,191864,27,572,5,1,96,40690,9451,50141
268,NAGALAND,Longleng,50484,26502,23982,29859,16139,13720,873,635,48849,5,77,0,0,45,12686,2451,15137
269,NAGALAND,Kiphire,74004,37830,36174,41232,22675,18557,1040,564,71803,13,210,1,1,372,16032,4290,20322
270,NAGALAND,Kohima,267988,138966,129022,197489,107038,90451,25496,4384,234955,998,1519,80,335,221,31845,44255,76100
271,NAGALAND,Peren,95219,49714,45505,62204,34584,27620,4076,1850,86145,15,459,10,2493,171,20204,4073,24277
272,MANIPUR,Senapati,479148,247323,231825,264477,148012,116465,43833,1649,426819,140,2409,53,1243,3002,38008,1826,39834
273,MANIPUR,Tamenglong,140651,72371,68280,85006,47403,37603,2995,589,134760,59,425,57,1144,622,23982,4119,28101
274,MANIPUR,Churachandpur,274143,138820,135323,195935,104013,91922,12034,2886,254979,152,495,87,2333,1177,52972,4853,57825
275,MANIPUR,Bishnupur,237399,118782,118617,156333,87313,69020,175102,18691,4264,56,76,16,38457,737,34977,21172,56149
276,MANIPUR,Thoubal,422168,210845,211323,269304,152617,116687,267146,107323,4322,106,114,24,42347,786,65961,38302,104263
277,MANIPUR,Imphal West,517992,255054,262938,392626,205985,186641,387497,24298,23377,589,1891,1264,77032,2044,51055,85746,136801
278,MANIPUR,Imphal East,456113,226094,230019,324664,173314,151350,274906,80199,27361,181,639,62,70825,1940,64421,46520,110941
279,MANIPUR,Ukhrul,183998,94718,89280,129829,70148,59681,7553,1115,174112,108,635,70,32,373,36084,5806,41890
280,MANIPUR,Chandel,144182,74579,69603,90302,51053,39249,10810,3086,129049,136,400,59,354,288,30377,3783,34160
281,MIZORAM,Mamit,86364,44828,41536,60191,32977,27214,2989,1782,69104,13,12328,25,19,104,16726,4129,20855
282,MIZORAM,Kolasib,83955,42918,41037,65895,34147,31748,4000,4426,75210,16,108,2,46,147,9669,12507,22176
283,MIZORAM,Aizawl,400309,199270,201039,340595,169547,171048,13249,5264,379134,105,1570,76,505,406,20570,80341,100911
284,MIZORAM,Champhai,125745,63388,62357,100802,51440,49362,1075,699,123446,9,151,45,194,126,18395,12717,31112
285,MIZORAM,Serchhip,64937,32851,32086,54476,27598,26878,991,335,63444,6,60,9,35,57,7472,8018,15490
286,MIZORAM,Lunglei,161428,82891,78537,121122,64515,56607,5231,1290,127124,74,27543,93,5,68,21479,17315,38794
287,MIZORAM,Lawngtlai,117894,60599,57295,62861,36444,26417,1668,522,63892,52,51549,122,2,87,21993,5273,27266
288,MIZORAM,Saiha,56574,28594,27980,42233,21861,20372,933,514,54977,11,102,4,2,31,7043,5784,12827
289,TRIPURA,West Tripura,1725739,879428,846311,1361354,722998,638356,1512801,152791,53622,499,2128,362,430,3106,289621,217016,506637
290,TRIPURA,South Tripura,876001,447544,428457,646810,351082,295728,736015,49258,39258,245,49420,106,808,891,219171,44906,264077
291,TRIPURA,Dhalai,378230,194544,183686,276217,151643,124574,307120,8256,22940,175,39120,85,206,328,89457,14071,103528
292,TRIPURA,North Tripura,693947,352860,341087,520402,275646,244756,507967,105737,44062,151,34717,307,70,936,150437,42184,192621
293,MEGHALAYA,West Garo Hills,643291,324159,319132,358702,193438,165264,122936,106788,389956,209,3392,144,16950,2916,139351,18594,157945
294,MEGHALAYA,East Garo Hills,317917,161223,156694,192147,102513,89634,17272,3359,289708,56,1004,38,5617,863,62698,11518,74216
295,MEGHALAYA,South Garo Hills,142334,73170,69164,82062,45003,37059,7036,1050,132984,27,332,10,362,533,35930,3713,39643
296,MEGHALAYA,West Khasi Hills,383461,193715,189746,230678,117307,113371,6498,1533,366881,58,1313,38,5878,1262,74832,12299,87131
297,MEGHALAYA,Ribhoi,258840,132531,126309,155859,80977,74882,30945,1838,218508,166,428,49,6308,598,57988,5736,63724
298,MEGHALAYA,East Khasi Hills,825922,410749,415173,578030,287270,290760,144935,14185,543394,2495,3111,303,115597,1902,106248,108843,215091
299,MEGHALAYA,Jaintia Hills,395124,196285,198839,187527,87371,100156,12456,1646,271596,34,284,45,107559,1504,76546,7171,83717
300,ASSAM,Kokrajhar,887142,452905,434237,489305,275220,214085,529068,252271,101091,93,1718,396,123,2382,204896,17115,222011
301,ASSAM,Dhubri,1949258,997848,951410,922341,511551,410790,388380,1553023,4107,254,101,1846,45,1502,460602,60417,521019
302,ASSAM,Goalpara,1008183,513292,494891,563577,304302,259275,347878,579929,77862,771,194,477,103,969,228610,39504,268114
303,ASSAM,Barpeta,1693622,867004,826618,897058,499038,398020,492966,1198036,1020,112,49,399,14,1026,447189,52192,499381
304,ASSAM,Morigaon,957423,486651,470772,539902,289698,250204,451882,503257,834,113,65,244,11,1017,232206,25275,257481
305,ASSAM,Nagaon,2823768,1439112,1384656,1710716,921850,788866,1225246,1563203,26844,3036,1073,1162,61,3143,674999,124186,799185
306,ASSAM,Sonitpur,1924110,983904,940206,1108572,620525,488047,1422824,350536,138166,1363,5088,1003,221,4909,483325,64528,547853
307,ASSAM,Lakhimpur,1042137,529674,512463,683486,375552,307934,797130,193476,46217,412,1074,250,2410,1168,293239,34694,327933
308,ASSAM,Dhemaji,686133,351249,334884,423028,237761,185267,655052,13475,8711,297,911,167,6315,1205,211758,16504,228262
309,ASSAM,Tinsukia,1327929,680231,647698,798322,453449,344873,1181347,48373,76877,1999,16228,837,395,1873,290704,90910,381614
310,ASSAM,Dibrugarh,1326335,676434,649901,884531,491361,393170,1198401,64526,52968,2261,4673,1055,46,2405,299852,77163,377015
311,ASSAM,Sivasagar,1151050,589216,561834,813505,444767,368738,1007277,95553,33147,902,3953,286,8541,1391,360182,45047,405229
312,ASSAM,Jorhat,1092256,556805,535451,794929,432335,362594,1008219,54684,21051,1540,2378,719,578,3087,286330,80824,367154
313,ASSAM,Golaghat,1066888,543161,523727,721764,396475,325289,917426,90312,50582,1131,3863,530,1347,1697,292893,34190,327083
314,ASSAM,Karbi Anglong,956313,490167,466146,557214,314253,242961,766000,20290,157789,370,6260,397,3568,1639,215691,37185,252876
315,ASSAM,Dima Hasao,214102,110802,103300,140873,78559,62314,143593,4358,63310,207,680,70,1170,714,37610,21309,58919
316,ASSAM,Cachar,1736617,886284,850333,1174128,639946,534182,1038985,654816,37635,280,341,1673,98,2789,346227,88933,435160
317,ASSAM,Karimganj,1228686,625864,602822,795297,435942,359355,521962,692489,11990,114,446,524,110,1051,261945,32695,294640
318,ASSAM,Hailakandi,659296,337890,321406,407366,226836,180530,251194,397653,8480,84,490,247,636,512,159215,16202,175417
319,ASSAM,Bongaigaon,738804,375818,362986,434078,237114,196964,359145,371033,5924,384,236,871,9,1202,181923,38470,220393
320,ASSAM,Chirang,482162,244860,237302,259902,145869,114033,320647,109248,49747,87,406,125,482,1420,129018,11613,140631
321,ASSAM,Kamrup,1517542,778461,739081,995319,550219,445100,877495,601784,33297,319,185,1330,55,3077,390596,43849,434445
322,ASSAM,Kamrup Metropolitan,1253938,647585,606353,1001191,537227,463964,1064412,151071,18810,3679,1627,9250,170,4919,61334,366858,428192
323,ASSAM,Nalbari,771639,396006,375633,531771,293184,238587,491582,277488,429,62,27,1004,9,1038,210706,28238,238944
324,ASSAM,Baksa,950075,481330,468745,572837,322614,250223,782901,135750,27076,156,1189,239,353,2411,291641,3580,295221
325,ASSAM,Darrang,928500,475273,453227,487039,268666,218373,327322,597392,1688,431,57,724,19,867,268517,20189,288706
326,ASSAM,Udalguri,831668,421617,410051,469926,264326,205600,612425,105319,110215,215,1681,124,229,1460,267790,13835,281625
327,WEST BENGAL,Darjiling,1846823,937259,909564,1315585,717673,597912,1366681,105086,141848,2032,209240,1840,15523,4573,303284,215675,518959
328,WEST BENGAL,Jalpaiguri,3872846,1983064,1889782,2498780,1396622,1102158,3156781,445817,186279,2994,50676,1461,23816,5022,798378,319426,1117804
329,WEST BENGAL,Koch Bihar,2819086,1451542,1367544,1850504,1028733,821771,2087766,720033,4122,449,445,1869,158,4244,803407,97331,900738
330,WEST BENGAL,Uttar Dinajpur,3007134,1551066,1456068,1489667,853495,636172,1482943,1501170,16702,477,432,1324,1622,2464,683981,94269,778250
331,WEST BENGAL,Dakshin Dinajpur,1676276,857199,819077,1083685,596474,487211,1232850,412788,24794,276,148,323,2786,2311,390949,70077,461026
332,WEST BENGAL,Maldah,3988845,2051541,1937304,2086432,1152019,934413,1914352,2045151,13209,747,359,639,7929,6459,830318,128678,958996
333,WEST BENGAL,Murshidabad,7103807,3627564,3476243,4055834,2177187,1878647,2359061,4707573,18102,766,348,3037,7429,7491,1501066,350899,1851965
334,WEST BENGAL,Birbhum,3502404,1790920,1711484,2158447,1201481,956966,2181515,1298054,10906,582,258,1152,6051,3886,831044,134565,965609
335,WEST BENGAL,Barddhaman,7717563,3966889,3750674,5247208,2918040,2329168,6008472,1599764,21220,16675,1602,1674,44968,23188,1364868,862368,2227236
336,WEST BENGAL,Nadia,5167600,2653768,2513832,3480555,1878866,1601689,3728482,1382682,33835,849,514,281,16893,4064,1081381,468390,1549771
337,WEST BENGAL,North Twenty Four Parganas,10009781,5119389,4890392,7608693,4056046,3552647,7352769,2584684,26933,9394,5818,4452,2930,22801,1209337,1649803,2859140
338,WEST BENGAL,Hugli,5519145,2814653,2704492,4078388,2211777,1866611,4574569,870204,7300,2662,1730,2160,49050,11470,992085,647953,1640038
339,WEST BENGAL,Bankura,3596674,1838095,1758579,2232992,1299337,933655,3033581,290450,3865,386,260,2904,260694,4534,900515,90885,991400
340,WEST BENGAL,Puruliya,2930115,1496996,1433119,1624905,1002058,622847,2373120,227249,8646,622,209,3052,309029,8188,653219,99433,752652
341,WEST BENGAL,Haora,4850029,2500819,2349210,3605206,1942824,1662382,3535844,1270641,8666,4380,1258,9699,1265,18276,483384,869313,1352697
342,WEST BENGAL,Kolkata,4496694,2356766,2139928,3588137,1926915,1661222,3440290,926414,39758,13849,4771,21178,1452,48982,0,1308106,1308106
343,WEST BENGAL,South Twenty Four Parganas,8161961,4173778,3988183,5531657,3043277,2488380,5155545,2903075,66498,2783,2494,972,6065,24529,1568802,611430,2180232
344,WEST BENGAL,Paschim Medinipur,5913457,3007885,2905572,4078412,2266913,1811499,5056953,620554,23287,2854,2019,1550,184278,21962,1364335,201048,1565383
345,WEST BENGAL,Purba Medinipur,5095875,2629834,2466041,3923194,2149073,1774121,4343972,743436,2648,746,317,574,359,3823,1193006,170707,1363713
346,JHARKHAND,Garhwa,1322784,683575,639209,653476,405161,248315,1104475,194680,17168,123,371,20,4591,1356,272872,19180,292052
347,JHARKHAND,Chatra,1042886,533935,508951,510061,303902,206159,903179,116710,6565,888,35,129,12936,2444,200974,14528,215502
348,JHARKHAND,Kodarma,716259,367222,349037,390249,238780,151469,605138,107018,1221,944,32,980,269,657,116714,34771,151485
349,JHARKHAND,Giridih,2445474,1258098,1187376,1253475,783736,469739,1856202,508586,14645,937,650,1503,59218,3733,452564,46886,499450
350,JHARKHAND,Deoghar,1492073,775022,717051,793538,489837,303701,1165140,302626,6027,143,188,282,16067,1600,257373,64337,321710
351,JHARKHAND,Godda,1313551,677927,635624,604519,376212,228307,937126,289182,37795,97,128,115,47067,2041,276454,15576,292030
352,JHARKHAND,Sahibganj,1150567,589391,561176,483263,287303,195960,628044,398243,83208,198,245,125,38426,2078,223450,37543,260993
353,JHARKHAND,Pakur,900422,452661,447761,352881,206989,145892,410127,322963,75865,356,283,222,88760,1846,200588,16587,217175
354,JHARKHAND,Dhanbad,2684487,1405956,1278531,1722204,1014950,707254,2149480,431762,11243,9727,331,1268,77182,3494,258764,405455,664219
355,JHARKHAND,Bokaro,2062330,1072807,989523,1273520,759088,514432,1636460,241451,13730,4174,1890,2045,160524,2056,250312,258452,508764
356,JHARKHAND,Lohardaga,461790,232629,229161,259707,149568,110139,112378,95012,16770,51,33,15,235987,1544,96759,14725,111484
357,JHARKHAND,Purbi Singhbhum,2293919,1176902,1117017,1507699,856526,651173,1550178,203999,30172,38544,892,1670,465367,3097,262537,342126,604663
358,JHARKHAND,Palamu,1939869,1006302,933567,1024563,621706,402857,1683169,238295,6164,734,188,284,5681,5354,355529,52375,407904
359,JHARKHAND,Latehar,726978,369666,357312,350682,209706,140976,473049,69808,47653,120,128,16,133525,2679,146377,14137,160514
360,JHARKHAND,Hazaribagh,1734495,890881,843614,1013249,596113,417136,1397227,281247,17137,1312,71,1676,34154,1671,312983,68765,381748
361,JHARKHAND,Ramgarh,949443,494230,455213,596497,350031,246466,774251,129037,7260,5093,69,537,32378,818,134067,118558,252625
362,JHARKHAND,Dumka,1321442,668514,652928,672409,406275,266134,1044726,106865,86404,234,267,162,78622,4162,303697,23281,326978
363,JHARKHAND,Jamtara,791042,404830,386212,426312,258260,168052,550560,164406,4419,520,118,783,68564,1672,165555,20113,185668
364,JHARKHAND,Ranchi,2914253,1494937,1419316,1911433,1085244,826189,1612239,410759,193974,4826,932,2733,677445,11345,420740,310242,730982
365,JHARKHAND,Khunti,531885,266335,265550,284575,164741,119834,138863,13122,136438,69,245,148,241292,1708,123245,12474,135719
366,JHARKHAND,Gumla,1025213,514390,510823,559720,321795,237925,309563,51429,202449,221,531,23,457468,3529,216629,16445,233074
367,JHARKHAND,Simdega,599578,300309,299269,343483,191991,151492,201524,15103,306601,51,753,114,73930,1502,144169,11114,155283
368,JHARKHAND,Pashchimi Singhbhum,1502338,749385,752953,727561,439273,288288,423937,38103,87587,946,389,52,945864,5460,336928,63396,400324
369,JHARKHAND,Saraikela-Kharsawan,1065056,544411,520645,612993,365332,247661,709016,63588,8113,1114,187,72,280469,2497,217248,68439,285687
370,ORISSA,Bargarh,1481255,749161,732094,983783,557217,426566,1459065,7527,11744,652,161,125,44,1937,411566,47395,458961
371,ORISSA,Jharsuguda,579505,296690,282815,405879,228092,177787,553587,12783,10462,1441,80,70,67,1015,103224,73962,177186
372,ORISSA,Sambalpur,1041099,526877,514222,703691,393192,310499,964188,20120,50637,2506,310,86,1117,2135,220697,94798,315495
373,ORISSA,Debagarh,312520,158230,154290,197819,112649,85170,296001,704,14518,53,102,7,409,726,91408,7350,98758
374,ORISSA,Sundargarh,2093437,1061147,1032290,1342322,750147,592175,1532352,71391,385011,5713,710,721,89986,7553,387911,230151,618062
375,ORISSA,Kendujhar,1801733,906487,895246,1052518,605119,447399,1752694,27752,9141,2177,209,131,7372,2257,490634,83664,574298
376,ORISSA,Mayurbhanj,2519738,1256213,1263525,1369397,794171,575226,2113079,33706,15008,661,162,109,351714,5299,689110,64479,753589
377,ORISSA,Baleshwar,2320529,1185787,1134742,1621232,902359,718873,2197709,94254,6434,237,111,201,18345,3238,601154,82440,683594
378,ORISSA,Bhadrak,1506337,760260,746077,1094140,596269,497871,1398543,104202,745,169,81,111,61,2425,373862,54244,428106
379,ORISSA,Kendrapara,1440361,717814,722547,1089265,579970,509295,1386792,50247,1423,169,62,52,24,1592,414749,23494,438243
380,ORISSA,Jagatsinghapur,1136971,577865,559106,889027,481049,407978,1086140,46929,1604,206,74,58,63,1897,309685,43047,352732
381,ORISSA,Cuttack,2624470,1352760,1271710,2011469,1103033,908436,2457729,141263,11985,1026,6276,1180,168,4843,579529,210768,790297
382,ORISSA,Jajapur,1827192,926034,901158,1290455,706396,584059,1725595,93642,1623,470,58,100,3073,2631,495611,45528,541139
383,ORISSA,Dhenkanal,1192811,612593,580218,829910,464093,365817,1185542,4805,727,124,366,39,139,1069,315390,36979,352369
384,ORISSA,Anugul,1273821,655718,618103,869456,494425,375031,1258684,7512,3383,812,226,36,971,2197,340410,74177,414587
385,ORISSA,Nayagarh,962789,502636,460153,688362,392333,296029,955754,5278,383,107,33,24,12,1198,261646,26688,288334
386,ORISSA,Khordha,2251673,1167137,1084536,1749936,957515,792421,2147632,84060,12527,1264,475,476,434,4805,331834,356895,688729
387,ORISSA,Puri,1698730,865380,833350,1291939,704857,587082,1644905,46094,4239,193,243,94,302,2660,402014,72210,474224
388,ORISSA,Ganjam,3529031,1779218,1749813,2210050,1262652,947398,3486059,13315,23975,590,174,170,76,4672,795476,219918,1015394
389,ORISSA,Gajapati,577817,282882,294935,262537,153663,108874,353160,1556,219482,53,2180,66,4,1316,152095,23050,175145
390,ORISSA,Kandhamal,733110,359945,373165,399786,233900,165886,580300,2138,148895,82,290,47,23,1335,218446,24489,242935
391,ORISSA,Baudh,441162,221625,219537,271612,158648,112964,438152,1007,522,24,5,11,7,1434,131377,6577,137954
392,ORISSA,Subarnapur,610183,311312,298871,398421,230393,168028,605225,1566,2374,58,46,17,6,891,176927,16575,193502
393,ORISSA,Balangir,1648997,830097,818900,927260,545672,381588,1618175,7811,16271,565,467,2225,141,3342,476770,62192,538962
394,ORISSA,Nuapada,610382,301962,308420,299383,180903,118480,601092,4952,1778,724,76,905,22,833,197258,11869,209127
395,ORISSA,Kalahandi,1576869,787101,789768,802036,484177,317859,1555367,4975,11160,796,175,1225,220,2951,456336,38412,494748
396,ORISSA,Rayagada,967911,471960,495951,407735,241959,165776,874445,4607,84916,219,249,123,44,3308,237343,49205,286548
397,ORISSA,Nabarangapur,1220946,604812,616134,470379,286984,183395,1178005,6753,32152,169,189,325,54,3299,342840,29424,372264
398,ORISSA,Koraput,1379647,678809,700838,568090,340843,227247,1294151,8850,68550,518,219,491,3384,3484,381789,78339,460128
399,ORISSA,Malkangiri,613192,303624,309568,244706,147001,97705,600219,1871,10039,213,43,195,35,577,167884,15839,183723
400,CHHATTISGARH,Koriya,658917,334737,324180,397823,229923,167900,604259,25878,9398,1391,84,1155,15474,1278,121852,59763,181615
401,CHHATTISGARH,Surguja,2359886,1193129,1166757,1187941,694686,493255,2126195,81442,97432,2303,1287,623,48295,2309,525596,65167,590763
402,CHHATTISGARH,Jashpur,851669,424747,426922,495415,280656,214759,629509,15336,189588,474,467,694,14835,766,205670,20722,226392
403,CHHATTISGARH,Raigarh,1493984,750278,743706,951639,542756,408883,1422986,17332,47653,2117,781,409,1782,924,354278,66638,420916
404,CHHATTISGARH,Korba,1206640,612915,593725,748759,433391,315368,1133176,30195,21059,3666,897,753,15649,1245,206598,126055,332653
405,CHHATTISGARH,Janjgir - Champa,1619707,815717,803990,1019634,593679,425955,1597089,14173,2926,635,556,707,2220,1401,379583,61190,440773
406,CHHATTISGARH,Bilaspur,2663629,1351574,1312055,1596560,932474,664086,2540763,57973,20745,6373,2979,2357,29122,3317,549632,188174,737806
407,CHHATTISGARH,Kabeerdham,822526,412058,410468,414167,248503,165664,776013,12206,980,924,433,1167,30222,581,187311,23868,211179
408,CHHATTISGARH,Rajnandgaon,1537133,762855,774278,1008379,561355,447024,1399658,23648,5193,3761,28541,8187,67444,701,313604,76528,390132
409,CHHATTISGARH,Durg,3343872,1682101,1661771,2303378,1284612,1018766,3129745,83499,24304,24276,19587,17209,42569,2683,533448,349741,883189
410,CHHATTISGARH,Raipur,4063872,2048186,2015686,2629749,1493158,1136591,3881485,103038,23181,16707,8397,17137,10680,3247,673499,395001,1068500
411,CHHATTISGARH,Mahasamund,1032754,511967,520787,637963,364089,273874,1008061,12570,5284,2941,521,1495,1417,465,274793,35774,310567
412,CHHATTISGARH,Dhamtari,799781,397897,401884,546833,303924,242909,777188,10425,2644,1196,667,3612,3685,364,168689,41792,210481
413,CHHATTISGARH,Uttar Bastar Kanker,748941,373338,375603,456042,258298,197744,627460,6040,4007,552,2213,1071,105869,1729,169191,24878,194069
414,CHHATTISGARH,Bastar,1413199,698487,714712,650863,382335,268528,1277975,12413,27951,2099,985,3466,86925,1385,316425,54894,371319
415,CHHATTISGARH,Narayanpur,139820,70104,69716,56621,33449,23172,129161,776,600,96,71,409,8542,165,26916,6179,33095
416,CHHATTISGARH,Dakshin Bastar Dantewada,533638,264142,269496,191237,116529,74708,513915,6437,4888,457,352,1044,6071,474,106545,31304,137849
417,CHHATTISGARH,Bijapur,255230,128663,126567,86919,54076,32843,245151,1617,2709,68,1649,15,3793,228,50449,7942,58391
418,MADHYA PRADESH,Sheopur,687861,361784,326077,328025,208201,119824,638702,41396,230,6387,201,379,40,526,150146,26376,176522
419,MADHYA PRADESH,Morena,1965970,1068417,897553,1179685,747652,432033,1875495,76159,1092,557,3234,6681,92,2660,319298,95288,414586
420,MADHYA PRADESH,Bhind,1703005,926843,776162,1094917,676513,418404,1595400,66776,973,4047,12215,19950,73,3571,271211,88385,359596
421,MADHYA PRADESH,Gwalior,2032036,1090327,941709,1357210,803114,554096,1835299,141735,4119,24790,4361,18058,217,3457,172720,272172,444892
422,MADHYA PRADESH,Datia,786754,420157,366597,491445,303815,187630,747693,28483,683,490,7923,453,10,1019,160453,43401,203854
423,MADHYA PRADESH,Shivpuri,1726050,919795,806255,900846,573242,327604,1648749,51200,1117,7151,3421,12171,72,2169,367859,66759,434618
424,MADHYA PRADESH,Tikamgarh,1445166,760355,684811,747940,459353,288587,1383475,44143,588,251,109,15569,39,992,322772,60220,382992
425,MADHYA PRADESH,Chhatarpur,1762375,936121,826254,943033,572010,371023,1676918,70351,1980,968,250,10409,102,1397,375869,95048,470917
426,MADHYA PRADESH,Panna,1016520,533480,483040,552559,332140,220419,974748,35214,418,186,37,4734,218,965,256744,32179,288923
427,MADHYA PRADESH,Sagar,2378458,1256257,1122201,1545719,908607,637112,2198297,103480,5580,4146,991,62992,168,2804,448408,165507,613915
428,MADHYA PRADESH,Damoh,1264219,661873,602346,747715,445737,301978,1186420,47966,1681,1096,119,25005,82,1850,303387,66514,369901
429,MADHYA PRADESH,Satna,2228935,1157495,1071440,1371781,801051,570730,2158623,59471,2228,1163,364,3135,1689,2262,461831,114173,576004
430,MADHYA PRADESH,Rewa,2365106,1225100,1140006,1441757,845572,596185,2268838,85414,1964,832,986,655,232,6185,523910,94489,618399
431,MADHYA PRADESH,Umaria,644758,330674,314084,356672,210907,145765,620515,15966,667,190,70,220,6028,1102,138100,29966,168066
432,MADHYA PRADESH,Neemuch,826067,422653,403414,508834,307889,200945,741288,67324,1508,1110,224,14165,115,333,174235,67962,242197
433,MADHYA PRADESH,Mandsaur,1340411,682851,657560,834591,502898,331693,1192588,125548,1120,849,242,19029,77,958,302287,81832,384119
434,MADHYA PRADESH,Ratlam,1455069,738241,716828,825880,485090,340790,1267043,151071,3996,1353,175,29353,123,1955,266716,107151,373867
435,MADHYA PRADESH,Ujjain,1986864,1016289,970575,1240990,730817,510173,1718204,233133,4659,3241,945,24622,211,1849,300765,188684,489449
436,MADHYA PRADESH,Shajapur,1512681,780520,732161,894612,543509,351103,1321003,174724,815,631,179,13755,66,1508,312611,73997,386608
437,MADHYA PRADESH,Dewas,1563715,805359,758356,925369,550716,374653,1376591,174259,2355,2330,382,6497,72,1229,274995,101014,376009
438,MADHYA PRADESH,Dhar,2185793,1112725,1073068,1077338,638479,438859,2051219,116202,2261,1607,328,12199,88,1889,412348,103364,515712
439,MADHYA PRADESH,Indore,3276697,1699627,1577070,2309130,1289631,1019499,2728225,415142,18523,25696,11496,71667,720,5228,200371,587947,788318
440,MADHYA PRADESH,Khargone (West Nimar),1873046,953121,919925,986234,575428,410806,1725441,135085,2075,2896,284,6028,89,1148,383543,76620,460163
441,MADHYA PRADESH,Barwani,1385881,699340,686541,549926,313642,236284,1318869,58222,2967,2361,416,2289,263,494,250358,48912,299270
442,MADHYA PRADESH,Rajgarh,1545814,790212,755602,804245,488797,315448,1433879,106928,1243,460,121,1599,50,1534,331894,69823,401717
443,MADHYA PRADESH,Vidisha,1458875,769568,689307,862918,512344,350574,1287391,149548,1313,914,295,18490,70,854,292579,83830,376409
444,MADHYA PRADESH,Bhopal,2371061,1236130,1134931,1660690,920314,740376,1755861,525434,23432,10789,21688,25950,335,7572,118893,581826,700719
445,MADHYA PRADESH,Sehore,1311332,683743,627589,780362,469208,311154,1163607,137980,1404,640,357,6232,66,1046,270427,59220,329647
446,MADHYA PRADESH,Raisen,1331597,700358,631239,820220,479093,341127,1195235,120331,1725,2262,253,10637,190,964,251272,74441,325713
447,MADHYA PRADESH,Betul,1575362,799236,776126,939769,529783,409986,1505745,37590,3271,1078,9651,3759,13048,1220,318945,87704,406649
448,MADHYA PRADESH,Harda,570465,294838,275627,352550,203807,148743,527462,38640,683,676,93,1573,55,1283,112714,31845,144559
449,MADHYA PRADESH,Hoshangabad,1241350,648725,592625,810644,469199,341445,1175203,52269,4453,3127,1550,3888,107,753,209650,105746,315396
450,MADHYA PRADESH,Katni,1292042,662013,630029,790773,460583,330190,1240650,37232,3158,1167,157,5342,2643,1693,276151,72880,349031
451,MADHYA PRADESH,Jabalpur,2463289,1277278,1186011,1756468,980307,776161,2159065,203652,23142,13256,4320,33728,21010,5116,272284,352477,624761
452,MADHYA PRADESH,Narsimhapur,1091854,568810,523044,718785,413491,305294,1038628,39048,914,997,262,8125,2873,1007,230659,53059,283718
453,MADHYA PRADESH,Dindori,704524,351913,352611,378714,222759,155955,605435,6736,4238,260,61,687,84006,3101,218021,9774,227795
454,MADHYA PRADESH,Mandla,1054905,525272,529633,604962,348033,256929,849518,16558,12450,436,297,1789,170533,3324,279674,37258,316932
455,MADHYA PRADESH,Chhindwara,2090922,1064468,1026454,1294198,731294,562904,1923920,100692,4893,2258,24471,7830,25771,1087,413142,140802,553944
456,MADHYA PRADESH,Seoni,1379131,695879,683252,864194,485341,378853,1145052,79739,1857,360,7288,4982,135315,4538,335045,47542,382587
457,MADHYA PRADESH,Balaghat,1701698,842178,859520,1147623,626468,521155,1519384,38542,5295,1050,72162,4778,58064,2423,400074,70793,470867
458,MADHYA PRADESH,Guna,1241519,649362,592157,653980,400537,253443,1172248,49203,1208,3271,529,13474,52,1534,212765,72320,285085
459,MADHYA PRADESH,Ashoknagar,845071,443837,401234,469109,290304,178805,778214,40707,635,8009,1352,15094,27,1033,169606,37135,206741
460,MADHYA PRADESH,Shahdol,1066063,540021,526042,604194,348761,255433,997073,42426,2372,912,268,1737,19448,1827,233594,57846,291440
461,MADHYA PRADESH,Anuppur,749237,379114,370123,436595,254120,182475,686524,21473,2132,606,86,1653,35434,1329,147388,60325,207713
462,MADHYA PRADESH,Sidhi,1127033,575912,551121,600785,353030,247755,1077545,34419,511,128,92,93,12556,1689,250953,25916,276869
463,MADHYA PRADESH,Singrauli,1178273,613637,564636,585054,359923,225131,1118998,46574,2332,1422,338,182,6139,2288,228732,58593,287325
464,MADHYA PRADESH,Jhabua,1025048,515023,510025,352081,214582,137499,960925,15733,38423,141,65,8871,388,502,211080,24713,235793
465,MADHYA PRADESH,Alirajpur,728999,362542,366457,209754,120905,88849,705060,17660,4600,65,36,780,271,527,135866,14662,150528
466,MADHYA PRADESH,Khandwa (East Nimar),1310061,674329,635732,731615,432259,299356,1182330,116277,2800,1726,1425,3856,158,1489,265663,63425,329088
467,MADHYA PRADESH,Burhanpur,757847,388504,369343,408679,233073,175606,552526,180840,1199,1074,19883,1884,99,342,115979,62861,178840
468,GUJARAT,Kachchh,2092371,1096737,995634,1252319,739239,513080,1608921,442355,6192,6353,490,25312,98,2650,488293,250982,739275
469,GUJARAT,Banas Kantha,3120506,1610379,1510127,1704923,1048402,656521,2890305,213505,1686,486,281,12659,83,1501,666773,137424,804197
470,GUJARAT,Patan,1343734,694397,649337,837913,494631,343282,1194745,142797,916,337,66,3602,66,1205,301483,102655,404138
471,GUJARAT,Mahesana,2035064,1056520,978544,1502645,847499,655146,1885732,136431,1954,1082,146,7087,88,2544,476005,183738,659743
472,GUJARAT,Sabar Kantha,2428589,1244231,1184358,1578734,918625,660109,2260560,148563,6375,614,168,11110,52,1147,544024,121509,665533
473,GUJARAT,Gandhinagar,1391753,723864,667889,1030494,582686,447808,1319586,57273,3237,1985,497,6405,82,2688,237624,195634,433258
474,GUJARAT,Ahmadabad,7214225,3788051,3426174,5435760,3025463,2410297,6042416,883238,50754,14542,4518,209287,2055,7415,353169,1845383,2198552
475,GUJARAT,Surendranagar,1756268,909917,846351,1093626,643221,450405,1620282,109681,1419,512,312,22992,128,942,340788,159810,500598
476,GUJARAT,Rajkot,3804558,1974445,1830113,2725056,1514075,1210981,3397406,361388,5478,1918,1170,33591,269,3338,459474,721532,1181006
477,GUJARAT,Jamnagar,2160119,1114192,1045927,1396534,795140,601394,1810443,320805,4392,1873,1086,18856,136,2528,347158,299167,646325
478,GUJARAT,Porbandar,585449,300209,285240,393678,221621,172057,549749,33565,500,248,91,515,38,743,96015,87557,183572
479,GUJARAT,Junagadh,2743082,1404356,1338726,1842818,1046981,795837,2397056,334858,2586,1110,1291,3841,77,2263,489237,287506,776743
480,GUJARAT,Amreli,1514190,771049,743141,995459,558180,437279,1410463,99105,919,415,243,2053,40,952,313714,116899,430613
481,GUJARAT,Bhavnagar,2880365,1490201,1390164,1887255,1087371,799884,2632574,212863,3457,1410,445,26974,127,2515,387251,356826,744077
482,GUJARAT,Anand,2092745,1087224,1005521,1551253,874481,676772,1798794,250919,29789,1524,267,8591,142,2719,413078,208909,621987
483,GUJARAT,Kheda,2299885,1185727,1114158,1660243,942480,717763,2000884,264482,26629,1403,300,3479,82,2626,461479,160547,622026
484,GUJARAT,Panch Mahals,2390776,1226961,1163815,1440805,858054,582751,2220974,158513,2863,662,337,5236,131,2060,463363,104238,567601
485,GUJARAT,Dohad,2127086,1068651,1058435,1007171,599035,408136,2045243,66353,9907,493,260,3331,114,1385,323697,52807,376504
486,GUJARAT,Vadodara,4165626,2153736,2011890,2893080,1614087,1278993,3713941,384579,23813,9340,2069,27650,1124,3110,547454,692971,1240425
487,GUJARAT,Narmada,590297,301086,289211,370336,211767,158569,559848,22600,4413,147,80,373,2078,758,138121,22248,160369
488,GUJARAT,Bharuch,1551019,805707,745312,1118276,623047,495229,1188204,343511,9494,1733,442,4813,342,2480,300677,181319,481996
489,GUJARAT,The Dangs,228291,113821,114470,140968,77314,63654,203545,3593,20029,69,32,39,560,424,52102,7516,59618
490,GUJARAT,Navsari,1329672,678165,651507,1001909,539471,462438,1225087,78669,5733,2459,601,13386,2823,914,267739,141417,409156
491,GUJARAT,Valsad,1705678,887222,818456,1170657,655528,515129,1571147,94034,19661,1589,913,13809,1417,3108,262410,235981,498391
492,GUJARAT,Surat,6081322,3402224,2679098,4571410,2687468,1883942,5260193,660772,21052,5703,12902,112835,3920,3945,369840,1529998,1899838
493,GUJARAT,Tapi,807022,402188,404834,490036,269007,221029,725890,22309,52930,239,1476,1828,408,1942,192272,26217,218489
494,DAMAN AND DIU,Diu,52074,25642,26432,38058,20327,17731,48613,3190,202,3,1,43,0,22,9788,9062,18850
495,DAMAN AND DIU,Daman,191173,124659,66514,150348,104316,46032,171537,16087,2618,169,216,244,79,223,10006,61073,71079
496,DADRA AND NAGAR HAVELI,Dadra AND Nagar Haveli,343709,193760,149949,223230,142521,80709,322857,12922,5113,217,634,1186,293,487,48221,60562,108783
497,MAHARASHTRA,Nandurbar,1648295,833170,815125,906509,512099,394410,1521618,96182,8467,685,4969,6191,2907,7276,333440,71572,405012
498,MAHARASHTRA,Dhule,2050862,1054031,996831,1293916,723388,570528,1825460,187901,3653,1422,13405,12818,912,5291,382777,146013,528790
499,MAHARASHTRA,Jalgaon,4229917,2197365,2032552,2891882,1629223,1262659,3457615,560261,7091,3091,143865,27404,9662,20928,796223,373565,1169788
500,MAHARASHTRA,Buldana,2586258,1337560,1248698,1879874,1048892,830982,1845424,354236,3531,1668,364229,12242,522,4406,575405,152787,728192
501,MAHARASHTRA,Akola,1813906,932334,881572,1411281,758977,652304,1107809,357253,4483,1504,328033,10205,389,4230,308158,196077,504235
502,MAHARASHTRA,Washim,1197160,620302,576858,869917,487703,382214,859949,142672,1707,518,179330,8476,381,4127,274925,55921,330846
503,MAHARASHTRA,Amravati,2888445,1480768,1407677,2251875,1207104,1044771,2055177,421410,7223,2242,383891,11360,3288,3854,508921,272894,781815
504,MAHARASHTRA,Wardha,1300774,668385,632389,1019458,552617,466841,1057096,53854,2696,2147,175417,5663,2254,1647,268486,120218,388704
505,MAHARASHTRA,Nagpur,4653570,2384975,2268595,3673808,1959220,1714588,3492202,390974,34667,20469,668050,24528,12181,10499,430844,877522,1308366
506,MAHARASHTRA,Bhandara,1200334,605520,594814,899860,488709,411151,1009352,26502,2145,831,154458,1017,3555,2474,283843,72575,356418
507,MAHARASHTRA,Gondiya,1322507,661554,660953,1004243,542837,461406,1153861,26157,1827,2160,125282,1568,5080,6572,319702,66813,386515
508,MAHARASHTRA,Gadchiroli,1072942,541328,531614,708365,395110,313255,927411,21063,3872,681,82695,454,30047,6719,293586,37254,330840
509,MAHARASHTRA,Chandrapur,2204307,1123834,1080473,1578615,872565,706050,1780085,92297,10701,5251,286734,3861,23188,2190,451324,233331,684655
510,MAHARASHTRA,Yavatmal,2772348,1419965,1352383,2022574,1115980,906594,2251401,239236,4567,1596,249874,11422,3745,10507,629243,168889,798132
511,MAHARASHTRA,Nanded,3361292,1730075,1631217,2189425,1255222,934203,2501741,471951,3902,13540,354189,5049,1273,9647,591119,230563,821682
512,MAHARASHTRA,Hingoli,1177345,606294,571051,790743,450551,340192,863199,127552,992,643,176679,5278,103,2899,242456,41913,284369
513,MAHARASHTRA,Parbhani,1836086,942870,893216,1157814,666291,491523,1328385,306364,2081,1371,187899,6238,262,3486,293480,133759,427239
514,MAHARASHTRA,Jalna,1959046,1011473,947573,1195523,699428,496095,1504641,274221,12542,1629,152540,9619,336,3518,404746,98084,502830
515,MAHARASHTRA,Aurangabad,3701282,1924469,1776813,2503837,1430936,1072901,2545438,786677,15991,5142,309093,30981,1005,6955,551789,427343,979132
516,MAHARASHTRA,Nashik,6107187,3157186,2950001,4345366,2397538,1947828,5237009,693052,23946,8912,94783,38212,1795,9478,904661,764271,1668932
517,MAHARASHTRA,Thane,11060148,5865078,5195070,8227161,4591396,3635765,8716055,1355630,280700,39149,449617,172052,9862,37083,713994,2904157,3618151
518,MAHARASHTRA,Mumbai Suburban,9356962,5031323,4325639,7575485,4223029,3352456,6337132,1795788,322476,47288,469568,343639,18345,22726,0,3078829,3078829
519,MAHARASHTRA,Mumbai,3085411,1684608,1400803,2509022,1410680,1098342,1873762,773173,84555,13471,134257,166000,31094,9099,0,1107321,1107321
520,MAHARASHTRA,Raigarh,2634200,1344345,1289855,1939994,1059692,880302,2239370,227465,17452,7477,121791,12260,1159,7226,581868,377160,959028
521,MAHARASHTRA,Pune,9429408,4924105,4505303,7171723,3940210,3231513,8090254,673704,134192,27090,340404,127786,9873,26105,1165718,2056739,3222457
522,MAHARASHTRA,Ahmadnagar,4543159,2342825,2200334,3151890,1773355,1378535,4107143,320743,22766,5431,33898,38718,1408,13052,1041393,282011,1323404
523,MAHARASHTRA,Bid,2585049,1349106,1235943,1718507,987185,731322,2174672,320395,2097,824,68482,8719,399,9461,563114,135457,698571
524,MAHARASHTRA,Latur,2454196,1273140,1181056,1650672,932432,718240,2006984,367664,2387,935,66535,6387,310,2994,428616,157016,585632
525,MAHARASHTRA,Osmanabad,1657576,861535,796041,1137810,644304,493506,1437623,178925,942,340,28216,4530,195,6805,367158,77832,444990
526,MAHARASHTRA,Solapur,4317756,2227852,2089904,2910676,1651266,1259410,3795424,441254,9882,1279,35497,28134,568,5718,779929,376302,1156231
527,MAHARASHTRA,Satara,3003741,1510842,1492899,2225694,1201034,1024660,2691952,146970,4408,1182,141315,12810,676,4428,774522,200949,975471
528,MAHARASHTRA,Ratnagiri,1615069,761121,853948,1199392,619012,580380,1307211,187197,1990,230,113467,3347,95,1532,538538,100824,639362
529,MAHARASHTRA,Sindhudurg,849651,417332,432319,666067,348289,317778,780384,26264,15471,219,24762,1046,53,1452,295847,44989,340836
530,MAHARASHTRA,Kolhapur,3876001,1980658,1895343,2825845,1559760,1266085,3379906,286558,15573,1570,29766,154882,1274,6472,796496,382818,1179314
531,MAHARASHTRA,Sangli,2822143,1435728,1386415,2049467,1121550,927917,2440312,239607,9098,1260,38210,87453,769,5434,626872,226801,853673
532,ANDHRA PRADESH,Adilabad,2741239,1369597,1371642,1483347,856350,626997,2399901,275970,15422,1377,25510,617,322,22120,597466,220248,817714
533,ANDHRA PRADESH,Nizamabad,2551335,1250641,1300694,1389810,790214,599596,2123426,391596,19653,2357,1847,542,146,11768,565165,155133,720298
534,ANDHRA PRADESH,Karimnagar,3776269,1880800,1895469,2206829,1257238,949591,3491139,244723,24979,2086,332,312,115,12583,877236,288044,1165280
535,ANDHRA PRADESH,Medak,3033288,1523030,1510258,1637137,953406,683731,2637313,342449,34301,1309,554,457,217,16688,593653,195479,789132
536,ANDHRA PRADESH,Hyderabad,3943323,2018575,1924748,2892155,1542688,1349467,2046051,1713405,87522,11446,1268,19560,1929,62142,0,1066289,1066289
537,ANDHRA PRADESH,Rangareddy,5296741,2701008,2595733,3538028,1948784,1589244,4458858,617518,144037,8062,2041,3536,1629,61060,432098,1129224,1561322
538,ANDHRA PRADESH,Mahbubnagar,4053028,2050386,2002642,1940646,1158386,782260,3673456,334172,21345,658,290,388,267,22452,848963,161052,1010015
539,ANDHRA PRADESH,Nalgonda,3488809,1759772,1729037,2001019,1160757,840262,3249231,188646,35025,937,241,250,132,14347,833504,197433,1030937
540,ANDHRA PRADESH,Warangal,3512576,1759281,1753295,2065023,1179790,885233,3273755,197333,31377,1453,253,569,126,7710,758738,288249,1046987
541,ANDHRA PRADESH,Khammam,2797370,1390988,1406382,1630234,901640,728594,2595321,158887,33463,655,217,459,539,7829,669262,201363,870625
542,ANDHRA PRADESH,Srikakulam,2703114,1341738,1361376,1495381,857824,637557,2666950,9025,18879,193,77,160,106,7724,752752,149684,902436
543,ANDHRA PRADESH,Vizianagaram,2344474,1161477,1182997,1238388,707503,530885,2299129,16423,17853,380,114,815,183,9577,592458,157056,749514
544,ANDHRA PRADESH,Visakhapatnam,4290589,2138910,2151679,2568249,1422878,1145371,4105320,86330,77607,2301,850,2316,286,15579,718847,660493,1379340
545,ANDHRA PRADESH,East Godavari,5154296,2569688,2584608,3288577,1716933,1571644,4983330,77777,77825,738,413,4149,403,9661,1199479,406362,1605841
546,ANDHRA PRADESH,West Godavari,3936966,1964918,1972048,2652389,1379223,1273166,3733191,86142,109120,288,209,1578,211,6227,1007255,248373,1255628
547,ANDHRA PRADESH,Krishna,4517398,2267375,2250023,3009718,1598959,1410759,4023678,307043,145598,1393,863,6320,906,31597,909292,567042,1476334
548,ANDHRA PRADESH,Guntur,4887813,2440521,2447292,2960441,1634726,1325715,4217597,559770,89763,764,323,3282,332,15982,1069877,513113,1582990
549,ANDHRA PRADESH,Prakasam,3397448,1714764,1682684,1904435,1107686,796749,3150195,220654,18775,266,97,204,206,7051,873486,214089,1087575
550,ANDHRA PRADESH,Sri Potti Sriramulu Nellore,2963557,1492974,1470583,1832189,1011922,820267,2639737,288378,26202,678,239,2610,146,5567,689137,264376,953513
551,ANDHRA PRADESH,Y.S.R.,2882469,1451777,1430692,1716766,994699,722067,2391231,454108,23281,367,105,751,245,12381,590589,293504,884093
552,ANDHRA PRADESH,Kurnool,4053463,2039227,2014236,2127161,1246369,880792,3328380,670737,33165,737,255,2235,434,17520,783853,306982,1090835
553,ANDHRA PRADESH,Anantapur,4081148,2064495,2016653,2310960,1338474,972486,3599372,443456,20463,932,341,1417,309,14858,902997,341431,1244428
554,ANDHRA PRADESH,Chittoor,4174064,2090204,2083860,2667878,1484794,1183084,3737588,397870,24129,867,253,1322,358,11677,907970,395900,1303870
555,KARNATAKA,Belgaum,4779661,2423063,2356598,3052032,1725548,1326484,4038331,528412,18418,2037,1086,178310,149,12918,962777,356198,1318975
556,KARNATAKA,Bagalkot,1889752,950111,939641,1113412,641388,472024,1634229,219991,3433,443,412,25198,166,5880,324799,165858,490657
557,KARNATAKA,Bijapur,2177331,1111022,1066309,1248268,730566,517702,1786830,369588,2433,558,374,8665,499,8384,396449,131041,527490
558,KARNATAKA,Bidar,1703300,870665,832635,1042673,597198,445475,1289709,335184,35438,1145,30453,680,521,10170,287134,102269,389403
559,KARNATAKA,Raichur,1928812,964511,964301,979769,577213,402556,1634062,272022,10394,538,2265,4156,29,5346,330446,125402,455848
560,KARNATAKA,Koppal,1389920,699926,689994,809085,468785,340300,1218024,161770,4081,296,85,2898,461,2305,272968,64681,337649
561,KARNATAKA,Gadag,1064570,537147,527423,700177,397178,302999,907750,143665,3432,231,79,5993,74,3346,180066,111906,291972
562,KARNATAKA,Dharwad,1847023,937206,909817,1301664,711776,589888,1390020,386834,28747,1486,715,29037,2748,7436,199707,283397,483104
563,KARNATAKA,Uttara Kannada,1437169,726256,710913,1081906,582099,499807,1187306,187974,44530,305,12804,3624,64,562,334281,140511,474792
564,KARNATAKA,Haveri,1597668,819128,778540,1085443,603793,481650,1281878,297927,2406,419,68,9834,702,4434,315076,98488,413564
565,KARNATAKA,Bellary,2452595,1236954,1215641,1421621,813440,608181,2103633,320834,14014,1029,284,8044,54,4703,371604,251876,623480
566,KARNATAKA,Chitradurga,1659456,840843,818613,1087392,607188,480204,1520553,128751,3175,322,84,3778,128,2665,349704,97644,447348
567,KARNATAKA,Davanagere,1945497,986400,959097,1308540,720637,587903,1658465,265805,5420,307,164,6417,1743,7176,354680,176011,530691
568,KARNATAKA,Shimoga,1752753,877415,875338,1263016,674938,588078,1479424,234664,26521,400,120,9234,367,2023,352444,201662,554106
569,KARNATAKA,Udupi,1177361,562131,615230,926429,465704,460725,1009179,96740,65838,232,161,4534,155,522,269817,115572,385389
570,KARNATAKA,Chikmagalur,1137961,566622,571339,818345,438257,380088,1004553,101235,26000,182,109,4710,4,1168,311660,80766,392426
571,KARNATAKA,Tumkur,2678980,1350594,1328386,1813391,1006024,807367,2413812,245923,9130,477,187,5067,161,4223,685443,204799,890242
572,KARNATAKA,Bangalore,9621551,5022661,4598890,7512276,4078041,3434235,7725070,1248294,504863,13254,5531,83090,498,40951,300576,2967384,3267960
573,KARNATAKA,Mandya,1805769,905085,900684,1149649,638668,510981,1712695,77801,8506,322,299,3607,109,2430,458867,103435,562302
574,KARNATAKA,Hassan,1776421,883667,892754,1225256,668836,556420,1630814,120011,15611,289,623,5820,3,3250,496103,132878,628981
575,KARNATAKA,Dakshina Kannada,2089649,1034714,1054935,1666323,864019,802304,1403854,501896,171398,525,445,10397,138,996,332919,317373,650292
576,KARNATAKA,Kodagu,554519,274608,279911,412877,215302,197575,448986,87274,17130,139,126,250,220,394,181182,31792,212974
577,KARNATAKA,Mysore,3001127,1511600,1489527,1962180,1063766,898414,2631985,290549,39361,1255,16194,14419,493,6871,540596,380386,920982
578,KARNATAKA,Chamarajanagar,1020791,512231,508560,565279,312957,252322,942071,47210,22183,136,4872,761,140,3418,262680,57200,319880
579,KARNATAKA,Gulbarga,2566326,1301755,1264571,1427368,828359,599009,2011014,513125,8344,826,9589,4865,330,18233,400704,199303,600007
580,KARNATAKA,Yadgir,1174271,590329,583942,510003,306751,203252,997974,155340,8677,331,7970,1519,996,1464,207787,55208,262995
581,KARNATAKA,Kolar,1536401,776396,760005,1016219,564110,452109,1305431,199873,26722,253,150,2494,92,1386,326567,151042,477609
582,KARNATAKA,Chikkaballapura,1255104,636437,618667,783222,442158,341064,1100131,147810,4684,264,85,975,77,1078,315649,94053,409702
583,KARNATAKA,Bangalore Rural,990923,509172,481751,688749,385311,303438,890429,92252,5368,389,272,1045,85,1083,231052,95410,326462
584,KARNATAKA,Ramanagara,1082636,548008,534628,674758,378461,296297,959260,114311,6390,383,104,859,57,1272,266950,84834,351784
585,GOA,North Goa,818008,416677,401331,663060,351738,311322,622213,57941,134169,618,553,546,166,1802,115859,209230,325089
586,GOA,South Goa,640537,322463,318074,502427,264085,238342,341664,63623,231961,855,542,563,92,1237,88620,162873,251493
587,LAKSHADWEEP,Lakshadweep,64473,33123,31350,52553,28023,24530,1788,62268,317,8,10,11,7,64,5289,15953,21242
588,KERALA,Kasaragod,1307375,628613,678762,1037492,516476,521016,729987,486913,87454,151,362,130,152,2226,251641,166164,417805
589,KERALA,Kannur,2523003,1181446,1341557,2138434,1012956,1125478,1509592,742483,262526,424,1118,193,722,5945,306288,566191,872479
590,KERALA,Wayanad,817420,401684,415736,645585,328136,317449,404460,234185,174453,61,312,1797,286,1866,266183,11805,277988
591,KERALA,Kozhikode,3086293,1470942,1615351,2615443,1266939,1348504,1734958,1211131,131516,297,235,601,588,6967,323793,666543,990336
592,KERALA,Malappuram,4112920,1960328,2152592,3311315,1597404,1713911,1135259,2888849,81556,205,179,68,579,6225,634543,522586,1157129
593,KERALA,Palakkad,2809934,1359478,1450456,2239492,1122600,1116892,1875980,812936,114397,220,238,78,400,5685,665899,228442,894341
594,KERALA,Thrissur,3121200,1480763,1640437,2678548,1282261,1396287,1823442,532839,757484,259,278,62,585,6251,336748,715119,1051867
595,KERALA,Ernakulam,3282388,1619557,1662831,2855676,1425723,1429953,1509557,514397,1248137,860,614,1176,1083,6564,369694,804997,1174691
596,KERALA,Idukki,1108974,552808,556166,923010,471881,451129,541854,82206,481507,100,189,44,384,2690,391610,20823,412433
597,KERALA,Kottayam,1974551,968289,1006262,1749798,861592,888206,983598,126499,858608,204,358,83,565,4636,481967,196194,678161
598,KERALA,Alappuzha,2127789,1013142,1114647,1852797,890552,962245,1460447,224545,435056,268,146,74,311,6942,331419,392117,723536
599,KERALA,Pathanamthitta,1197412,561716,635696,1062553,499181,563372,681666,55074,456404,153,150,44,262,3659,414992,57848,472840
600,KERALA,Kollam,2635375,1246968,1388407,2240273,1074345,1165928,1697635,508500,421598,208,272,63,619,6480,523715,401415,925130
601,KERALA,Thiruvananthapuram,3301427,1581678,1719749,2785408,1354857,1430551,2194057,452915,630573,404,301,76,1082,22019,559293,609824,1169117
602,TAMIL NADU,Thiruvallur,3728104,1876062,1852042,2791721,1495711,1296010,3325823,143093,233633,1422,951,3693,530,18959,387237,732196,1119433
603,TAMIL NADU,Chennai,4646732,2335844,2310888,3776276,1968079,1808197,3751322,439270,358662,2851,2804,51708,1759,38356,0,1314125,1314125
604,TAMIL NADU,Kancheepuram,3998252,2012958,1985294,3013382,1611461,1401921,3537399,173785,256762,1620,990,4962,756,21978,438799,774705,1213504
605,TAMIL NADU,Vellore,3936331,1961688,1974643,2773928,1504355,1269573,3397857,414760,111390,676,438,3514,251,7445,653499,486801,1140300
606,TAMIL NADU,Tiruvannamalai,2464875,1235889,1228986,1626813,909803,717010,2294369,91636,66987,232,157,7898,110,3486,563102,147061,710163
607,TAMIL NADU,Viluppuram,3458873,1740819,1718054,2195776,1234479,961297,3174941,133896,138279,325,238,4032,278,6884,808042,159272,967314
608,TAMIL NADU,Salem,3482056,1781571,1700485,2285562,1285107,1000455,3326357,95487,53841,412,174,992,246,4547,572813,597539,1170352
609,TAMIL NADU,Namakkal,1726601,869280,857321,1176131,653312,522819,1673652,32483,16909,183,108,84,199,2983,370357,257127,627484
610,TAMIL NADU,Erode,2251744,1129868,1121876,1492662,828300,664362,2115455,76098,55899,435,148,639,157,2913,411286,432398,843684
611,TAMIL NADU,The Nilgiris,735394,360143,375251,569647,299447,270200,569477,78452,84610,338,382,910,87,1138,112126,151979,264105
612,TAMIL NADU,Dindigul,2159775,1080938,1078837,1481834,816180,665654,1879494,105012,169945,313,256,71,138,4546,443818,269724,713542
613,TAMIL NADU,Karur,1064493,528184,536309,727044,401726,325318,993666,53292,16483,115,29,7,79,822,212241,152420,364661
614,TAMIL NADU,Tiruchirappalli,2722290,1352284,1370006,2038981,1087765,951216,2279413,190964,246156,324,250,628,253,4302,452707,423020,875727
615,TAMIL NADU,Perambalur,565223,282157,283066,375823,208011,167812,521658,32702,10301,83,39,38,26,376,155413,33179,188592
616,TAMIL NADU,Ariyalur,754894,374703,380191,480604,269582,211022,708397,7942,37403,104,88,65,42,853,223955,30322,254277
617,TAMIL NADU,Cuddalore,2605914,1311697,1294217,1815281,1000322,814959,2391675,123749,83334,401,236,1280,138,5101,497429,260780,758209
618,TAMIL NADU,Nagapattinam,1616450,798127,818323,1213008,640916,572092,1435072,128617,47579,184,450,963,110,3475,399016,118724,517740
619,TAMIL NADU,Thiruvarur,1264277,626693,637584,946471,503085,443386,1132785,96092,33192,258,151,279,64,1456,321331,86848,408179
620,TAMIL NADU,Thanjavur,2405890,1182416,1223474,1790998,944264,846734,2075870,190814,133971,231,795,1256,148,2805,479070,274302,753372
621,TAMIL NADU,Pudukkottai,1618345,803188,815157,1110545,608776,501769,1428784,114194,72850,119,81,32,293,1992,399712,104229,503941
622,TAMIL NADU,Sivaganga,1339101,668672,670429,959744,526304,433440,1186078,74310,75481,150,80,109,24,2869,309224,143193,452417
623,TAMIL NADU,Madurai,3038252,1526475,1511777,2273430,1223810,1049620,2760502,168881,97711,520,199,1532,305,8602,417718,592723,1010441
624,TAMIL NADU,Theni,1245899,625683,620216,870080,479403,390677,1148990,56751,37574,152,79,28,74,2251,189328,221295,410623
625,TAMIL NADU,Virudhunagar,1942288,967709,974579,1398788,760375,638413,1822626,47838,67405,245,87,98,75,3914,363782,370942,734724
626,TAMIL NADU,Ramanathapuram,1353445,682658,670787,978946,536487,442459,1047411,208038,91139,154,86,29,36,6552,290478,126761,417239
627,TAMIL NADU,Thoothukkudi,1750176,865021,885155,1349697,703106,646591,1373920,80740,291908,127,286,53,112,3030,336078,300661,636739
628,TAMIL NADU,Tirunelveli,3077233,1520912,1556321,2273457,1210710,1062747,2425630,303368,342254,268,373,144,450,4746,547962,516705,1064667
629,TAMIL NADU,Kanniyakumari,1870374,926345,944029,1548738,780541,768197,909872,78590,876299,160,438,156,10,4849,104253,493788,598041
630,TAMIL NADU,Dharmapuri,1506843,774303,732540,917709,527599,390110,1452956,38304,14089,164,39,37,87,1167,396819,91107,487926
631,TAMIL NADU,Krishnagiri,1879809,960232,919577,1187958,667062,520896,1723737,115303,35956,468,121,373,221,3630,437988,142552,580540
632,TAMIL NADU,Coimbatore,3458045,1729297,1728748,2635907,1394790,1241117,3044145,211035,190314,1112,435,3284,237,7483,284795,884957,1169752
633,TAMIL NADU,Tiruppur,2479052,1246159,1232893,1760566,959623,800943,2278835,123983,70015,455,198,371,119,5076,356886,538022,894908
634,PONDICHERRY,Yanam,55626,27301,28325,39274,19919,19355,53537,1191,873,3,1,4,4,13,0,15519,15519
635,PONDICHERRY,PONDICHERRY,950289,468258,482031,726649,380946,345703,855294,32674,58328,245,366,1328,147,1907,87296,203741,291037
636,PONDICHERRY,Mahe,41816,19143,22673,36470,16610,19860,27940,12856,958,3,21,14,3,21,0,12110,12110
637,PONDICHERRY,Karaikal,200222,97809,102413,154916,79903,75013,152638,28835,18391,46,63,54,14,181,35618,33715,69333
638,ANDAMAN AND NICOBAR ISLANDS,Nicobars,36842,20727,16115,25332,15397,9935,8681,1336,26077,343,119,0,248,38,15958,0,15958
639,ANDAMAN AND NICOBAR ISLANDS,North  AND Middle Andaman,105597,54861,50736,78683,43186,35497,81163,2165,21870,77,84,4,47,187,39091,1094,40185
640,ANDAMAN AND NICOBAR ISLANDS,South Andaman,238142,127283,110859,190266,105794,84472,174452,28912,33037,866,135,27,269,444,34901,50631,85532
